阿柏怪[阿柏怪]	a1 bai3 guai4	Arbok Transliteration of Japanese name, with the character for "freak" added at the end
阿柏蛇[阿柏蛇]	a1 bai3 she2	Ekans Transliteration of the Japanese name, with the character for "snake" added at the end
阿勃梭鲁[阿勃梭魯]	a1 bo2 suo1 lu3	Absol Transliteration of its Japanese name
阿尔宙斯[阿爾宙斯]	a1 er3 Zhou4si1	Arceus Transliteration of its Japanese name. Also a portmanteau of 阿爾法 / 阿尔发 ā'ěrfǎ and 宙斯 Zhòusī.
阿利多斯[阿利多斯]	a1 li4duo1 si1	Ariados Transliteration of its Japanese name
哎呀球菇[哎呀球菇]	ai1ya1 qiu2 gu1	Foongus Formerly 寶貝球菇 Bǎobèiqiúgū (TW) 精靈球菇 Jīnglìhngkàuhgū (HK) From 哎呀 Āiyā!, 球 qiú, and 菇 gūFrom 寶貝球 Bǎobèi-qiú, 寶貝 bǎobèi, 球 qiú, and 菇 gū
爱心鱼[愛心魚]	ai4xin1 yu2	Luvdisc Literally "Love fish".
艾路雷朵[艾路雷朵]	ai4 lu4 lei2 duo3	Gallade Transliteration of Japanese name
艾姆利多[艾姆利多]	ai4 mu3 li4duo1	Mesprit Transliteration of Japanese name
安瓢虫[安瓢蟲]	an1 piao2chong2	Ledian From 安 ān and 瓢蟲 / 瓢虫piáochóng
傲骨燕[傲骨燕]	ao4gu3 yan4	Taillow Means "Lofty, unyielding swallow"
巴大蝶[巴大蝶]	ba1 da4 die2	Butterfree Formerly 巴大蝴 Bādàhú (TW/CN) 巴他蝶 Bātādihp (HK) Partial transliteration of Japanese name. 蝴 is from 蝴蝶 húdié
芭瓢虫[芭瓢蟲]	ba1 piao2chong2	Ledyba From 芭 bā and 瓢蟲 piáochóng
霸王花[霸王花]	ba4wang2 hua1	Vileplume A name for rafflesia. Literally "Tyrant flower"
白海狮[白海獅]	bai2 hai3shi1	Dewgong Means "White sea lion"
百变怪[百變怪]	bai3 bian4 guai4	Ditto Literally "Hundred transformation creature"
百合根娃娃[百合根娃娃]	bai3he2 gen1 wa2wa5	Petilil From 百合 bǎihé, 根 gēn, and 娃娃 wáwá
百足蜈蚣[百足蜈蚣]	bai3zu2 wu2gong5	Venipede Means "Hundred-foot centipede".
败露球菇[敗露球菇]	bai4lu4 qiu2 gu1	Amoonguss Formerly 暴露菇 Bàolùgū​ (TW) 暴露菇 Bouhlouhgū (HK) From 暴露 bàolù and 菇 gū​
搬运小匠[搬運小匠]	ban1yun4 xiao3 jiang4	Timburr From 搬運 bānyùn, 小 xiǎo, and 匠 jiàng.
斑斑马[斑斑馬]	ban1ban1 ma3	Blitzle From 斑馬 bānmǎ.
班基拉斯[班基拉斯]	Ban1ji1 la1 si1	Tyranitar Formerly 班吉拉 Bānjīlā (TW/CN) 班吉拉 Bāangātlāai (HK) Transliteration of its Japanese name.
保姆虫[保母蟲]	bao3mu3 chong2	Leavanny From 保姆 bǎo​mǔ, 母 mǔ, and 蟲 chóng.
保姆曼波[保母曼波]	bao3mu3 man4bo1	Alomomola From 保姆 bǎo​mǔ, 母 mǔ, and 曼波魚 mànbō-yú
宝包茧[寶包繭]	bao3 bao1 jian3	Swadloon From Sewaddle's Chinese name 蟲寶包, 包 meaning "wrap", and 繭 jiǎn.
宝宝暴龙[寶寶暴龍]	bao3bao5 bao4long2	Tyrunt Formerly 暴龍仔 Bouhlùhngjái (HK)  From 寶寶 bǎobǎo and 暴龍 bàolóng
宝宝丁[寶寶丁]	bao3bao5 ding1	Igglybuff Formerly 小波球 Síubōkàuh (HK)  From 寶寶 băobăo, 布丁 bùdīng and 丁 dīng
宝贝龙[寶貝龍]	bao3bei5 long2	Bagon Literally "Baby/darling dragon"
宝石海星[寶石海星]	bao3shi2 hai3xing1	Starmie Literally "Jewel starfish"
暴飞龙[暴飛龍]	bao4 fei1long2	Salamence Formerly 暴蠑螈 / 暴蝾螈 Bàoróngyuán (TW/CN) 暴蠑螈 Bouhwìhngyùhn (HK) Literally "Violent salamander".
暴鲤龙[暴鯉龍]	bao4 li3 long2	Gyarados Formerly 鯉魚龍 Léihyùhlùhng (HK)  Literally "Violent carp dragon". Possibly from 鯉躍龍門 Lǐ yuè Lóngmén and 龍鯉 Lónglǐ.
暴雪王[暴雪王]	bao4 xue3 wang2	Abomasnow From 暴風雪 bào​fēng​xuě and 王 wáng. Literally "Violent snow king"
爆肌蚊[爆肌蚊]	bao4 ji1 wen2	Buzzwole From 爆 bào, 肌 jī, and 蚊 wén
爆香猴[爆香猴]	bao4 xiang1 hou2	Pansear From 爆香 bàoxiāng and 猴 hóu.
爆香猿[爆香猿]	bao4 xiang1 yuan2	Simisear From 爆香 bàoxiāng and 猿 yuán.
爆焰龟兽[爆焰龜獸]	bao4 yan4 gui1 shou4	Turtonator From 爆炸 bàozhà, 火焰 huǒyàn, 龜 / 龟 guī, and 獸 / 兽 shòu
爆音怪[爆音怪]	bao4yin1 guai4	Exploud Literally "Sonic boom monster"
爆炸头水牛[爆炸頭水牛]	bao4zha4 tou2 shui3niu2	Bouffalant Formerly 爆爆頭水牛 / 爆爆头水牛 Bàobàotóushuǐniú (TW/CN) 爆爆頭水牛 Baaubaautàuhséuingàuh (HK) From 爆炸頭 Bàozhàtóu and 水牛 shuǐniú.
比比鸟[比比鳥]	bi3bi3 niao3	Pidgeotto Repetition of the first syllable of the Japanese name. The last character means bird
比克提尼[比克提尼]	bi3 ke4 ti2 ni2	Victini Transliteration of Japanese name
毕力吉翁[畢力吉翁]	bi4li4 ji2 weng1	Virizion Transliteration of Japanese name
变隐龙[變隱龍]	bian4 yin3 long2	Kecleon From 變色龍 biàn​sè​lóng and 隱 yǐn
冰宝[冰寶]	bing1 bao3	Bergmite 
冰鬼护[冰鬼護]	bing1 gui3 hu4	Glalie The characters 冰 and 鬼 comes from its Japanese name. 護 may refer to its shape as an ice hockey mask.
冰雪巨龙[冰雪巨龍]	bing1xue3 ju4long2	Aurorus From 冰雪 bīngxuě, 巨 jù, and 恐龍 kǒnglóng
冰雪龙[冰雪龍]	bing1 Xue3 Long2	Amaura From 冰雪 bīngxuě and 恐龍 kǒnglóng
冰岩怪[冰岩怪]	bing1 yan2 guai4	Avalugg 
冰伊布[冰伊布]	bing1 yi1 bu4	Glaceon Formerly 冰精靈 / 冰精灵 Bīngjīnglíng (TW/CN) 冰伊貝 Bīngyìhbui (HK) Means "Ice spirit". Ends with -精靈 / -精灵 like every Eeveelution in Mandarin.
波波[波波]	bo1bo1	Pidgey Transliteration of Japanese name
波尔凯尼恩[波爾凱尼恩]	bo1 er3 Kai3ni2en1	Volcanion Transliteration of its Japanese name
波皇子[波皇子]	bo1 huang2zi3	Prinplup From 波 bō, 皇子 huángzǐ, and 皇太子 huángtàizǐ
波加曼[波加曼]	bo1 jia1 man4	Piplup Transliteration of its Japanese name. Also from 波 bō
波克比[波克比]	bo1 ke4 bi3	Togepi Formerly 小刺蛋 Síuchidáan (HK)  Rough transliteration of its Japanese name
波克基古[波克基古]	bo1 ke4 ji1 gu3	Togetic Formerly 波剋基古 Bōkèjīgǔ (TW) 波剋基古 Bōhākgēigú (HK) Rough transliteration of its Japanese name
波克基斯[波克基斯]	bo1 ke4 ji1 si1	Togekiss Rough transliteration of its Japanese name
波士可多拉[波士可多拉]	bo1shi4 ke3 duo1 la1	Aggron Transliteration of its Japanese name
不良蛙[不良蛙]	bu4liang2 wa1	Croagunk Literally "Bad frog".
布里卡隆[布里卡隆]	bu4 li3 ka3 long2	Chesnaught Transliteration of Japanese name
布鲁[布魯]	Bu4lu3	Snubbull Formerly 布盧 / 布廬 / 布卢 / 布庐Bùlú (TW/CN)  Transliteration of its Japanese name
布鲁皇[布魯皇]	bu4 lu3 huang2	Granbull Formerly 布盧皇 / 布廬皇 / 布卢皇 Bùlúhuáng (TW/CN)  From 布盧 Bùlú and 皇 huáng
步哨鼠[步哨鼠]	bu4shao4 shu3	Watchog From 步哨 bùshào and 鼠 shǔ.
彩粉蝶[彩粉蝶]	cai3 fen3die2	Vivillon Formerly 碧粉蝶 Bìfěndié (TW) 碧粉蝶 Bīkfándihp (HK) From 碧 bì, 鱗粉 línfěn, and 蝶 dié
草苗龟[草苗龜]	cao3 miao2 gui1	Turtwig Literally "Grass sprout turtle"
叉字蝠[叉字蝠]	cha1 zi4 fu2	Crobat Literally "Cross-shaped bat"
差不多娃娃[差不多娃娃]	cha4bu5duo1 wa2wa5	Audino From 差不多 Chàbùduō and 娃娃 wáwá
蟾蜍王[蟾蜍王]	chan2chu2 wang2	Seismitoad Literally "Toad king".
长鼻叶[長鼻葉]	chang2bi2 ye4	Nuzleaf From 長鼻 chángbí and 葉 yè
长毛狗[長毛狗]	chang2mao2 gou3	Stoutland Literally "Shaggy dog".
长尾怪手[長尾怪手]	chang2wei3 guai4shou3	Aipom Literally "Long tail, strange hand", a reference to its tail
长尾火狐[長尾火狐]	chang2wei3 huo3hu2	Braixen 
超坏星[超壞星]	chao1 huai4 xing1	Toxapex From 超壞 / 超坏 chāohuài and 海星 hǎixīng
超甲狂犀[超甲狂犀]	chao1 jia3 kuang2 xi1	Rhyperior Formerly 超鐵暴龍 / 超铁暴龙 Chāotiěbàolóng (TW/CN) 超鐵暴龍 Chīutitbouhlùhng (HK) Literally "Super iron Tyrannosaurus".
超梦[超夢]	chao1 meng4	Mewtwo Formerly 超夢夢 Chīumuhngmuhng (HK)  Can either mean "Ultimate dream" or "To transcend dreams".
超能妙喵[超能妙喵]	chao1 neng2 miao4 miao1	Meowstic From 超能力 chāonénglì, 妙 miào and 喵 miāo
超音波幼虫[超音波幼蟲]	chao1yin1bo1 you4chong2	Vibrava Literally "Ultrasonic larva"
超音蝠[超音蝠]	chao1 yin1 fu2	Zubat Formerly 波音蝠 Bōyāmfūk (HK)  Literally "Supersonic bat"
朝北鼻[朝北鼻]	chao2 bei3bi2	Nosepass Literally "North-facing nose"
炒炒猪[炒炒豬]	chao3 chao3 zhu1	Pignite From 炒 chǎo and 豬 zhū.
车轮球[車輪毬]	che1lun2 qiu2	Whirlipede From 車輪 chēlún and 毬 qiú.
齿轮怪[齒輪怪]	chi3lun2 guai4	Klinklang From 齒輪 chǐlún and 怪 guài​
齿轮儿[齒輪兒]	chi3lun2 r5	Klink From 齒輪 chǐlún and 兒 ér​
齿轮组[齒輪組]	chi3lun2 zu3	Klang From 齒輪 chǐlún and 組 zǔ​​
炽焰咆哮虎[熾焰咆哮虎]	chi4yan4 pao2 xiao1 hu3	Incineroar From 熾 chì, 焰 yàn, 咆哮 páoxiāo, and 虎 hǔ
赤面龙[赤面龍]	chi4 mian4 long2	Druddigon Literally "Crimson-faced dragon"
虫宝包[蟲寶包]	chong2 bao3 bao1	Sewaddle From 蟲 chóng, 寶寶 bǎobǎo and 包 bāo.
虫电宝[蟲電寶]	chong2 dian4 bao3	Charjabug From 蟲 / 虫 chóng, 充電 / 充电 chōngdiàn, 充電寶 / 充电宝 chōngdiànbǎo, and 寶寶 / 宝宝 bǎobǎo
铳嘴大鸟[銃嘴大鳥]	chong4 zui3 da4 niao3	Toucannon From 銃 / 铳 chòng, 大 dà, and 巨嘴鳥 / 巨嘴鸟 jùzuǐniǎo
丑丑鱼[醜醜魚]	chou3 chou3 yu2	Feebas Formerly 笨笨魚 / 笨笨鱼 Bènbènyú (TW/CN) 笨笨魚 Bahnbahnyú (HK) Literally "Silly fish"
臭臭花[臭臭花]	chou4 chou4 hua1	Gloom Formerly 怪味花 Gwaaimeihfā (HK)  Literally "Stinky flower"
臭臭泥[臭臭泥]	chou4 chou4 ni2	Muk Formerly 爛泥獸 Laahnnàihsau (HK)  Means "Very foul sludge"
臭泥[臭泥]	chou4 ni2	Grimer Formerly 爛泥怪 Laahnnàihgwaai (HK)  Means "Foul sludge"
臭鼬噗[臭鼬噗]	chou4you4 pu1	Stunky 臭鼬 refers to skunk, while 噗 is the transliteration of "poo" in its Japanese name.
触手百合[觸手百合]	chu4shou3 bai3he2	Lileep Literally "Tentacled lily"
穿山鼠[穿山鼠]	chuan1 shan1shu3	Sandshrew A portmanteau of 穿山甲 and 鼠. Literally "Mouse that passes through mountains"
穿山王[穿山王]	chuan1 shan1 wang2	Sandslash A portmanteau of 穿山甲 and 王. Literally "King of going through mountains"
穿着熊[穿著熊]	chuan1zhuo2 xiong2	Bewear From 穿着 / 穿着 chuānzhuó and 熊 xióng
刺甲贝[刺甲貝]	ci4 jia3 bei4	Cloyster Formerly 鐵甲貝 / 铁甲贝 Tiějiǎbèi (TW/CN) 鐵甲貝 Titgaapbui (HK) Means "Armored shell"
刺龙王[刺龍王]	ci4 Long2wang2	Kingdra Literally "Sting dragon king"
刺球仙人掌[刺球仙人掌]	ci4 qiu2 xian1ren2zhang3	Cacnea Formerly 沙漠奈亞 / 沙漠奈亚 Shāmònàiyǎ / Shāmònàiyà (TW/CN) 沙漠奈亞 Sāmohknoih'a (HK) From 沙漠 shāmò and 奈亞 nàiyǎ
刺尾虫[刺尾蟲]	ci4 wei3 chong2	Wurmple Literally "Sting-tailed bug"
催眠貘[催眠貘]	cui1mian2 mo4	Drowzee Formerly 素利普 Sùlìpǔ (TW/CN) 食夢獸 Sihkmuhngsau (HK) Transliteration of Japanese name
达克莱伊[達克萊伊]	da2 Ke4lai2 yi1	Darkrai Transliteration of Japanese name
达摩狒狒[達摩狒狒]	Da2mo2 fei4fei4	Darmanitan From 達摩 / 达摩 Dámó and 狒狒 fèifèi
打击鬼[打擊鬼]	da3ji1 gui3	Sawk From 打擊 dǎjí and the Japanese 鬼 ki (oni).
大比鸟[大比鳥]	da4bi3 niao3	Pidgeot Formerly 比鵰 / 比雕 Bǐdiāo (TW/CN)  Transliteration of the first syllable of its Japanese name. The last character means eagle
大朝北鼻[大朝北鼻]	da4 chao2 bei3bi2	Probopass From 大 dà and 朝北鼻 Cháoběibí. Literally "Big north-facing nose" or "Big Nosepass".
大葱鸭[大蔥鴨]	da4cong1 ya1	Farfetch'd Formerly 火蔥鴨 Fóchūng'aap (HK)  Means "Scallion duck". 大蔥 literally means "Big scallion"
大颚蚁[大顎蟻]	da4 e4 yi3	Trapinch Literally "Big jaw ant"
大钢蛇[大鋼蛇]	da4 gang1 she2	Steelix Literally "Large steel snake"
大剑鬼[大劍鬼]	da4 jian4 gui3	Samurott Transliteration of Japanese name
大狼犬[大狼犬]	da4 lang2quan3	Mightyena Literally "Big wolf dog"
大力鳄[大力鱷]	da4li4 e4	Feraligatr Means "Energetic crocodilian"
大奶罐[大奶罐]	da4 nai3 guan4	Miltank Can be taken as "Big milk tank"
大钳蟹[大鉗蟹]	da4qian2 xie4	Krabby Means "Crab with big pincers"
大舌贝[大舌貝]	da4 she2 bei4	Shellder Formerly 貝殼怪 Buihokgwaai (HK)  Literally "Big-tongued shell"
大舌舔[大舌舔]	da4 she2 tian3	Lickilicky Literally "Large tongue lick".
大舌头[大舌頭]	da4she2tou5	Lickitung Literally "Big tongue"
大食花[大食花]	Da4shi2 hua1	Victreebel Means "Flower with big appetite"
大王燕[大王燕]	da4wang2 yan4	Swellow Literally "King swallow"
大尾狸[大尾狸]	da4 wei3 li2	Bibarel 大尾 means big tail. 狸 is derived from 河狸.
大尾立[大尾立]	da4 wei3 li4	Furret Literally "Big tail stand"
大牙狸[大牙狸]	da4ya2 li2	Bidoof 大牙 means big teeth. 狸 is derived from 河狸.
大岩蛇[大岩蛇]	da4 yan2 she2	Onix Literally "Big boulder snake"
大宇怪[大宇怪]	Da4yu3 guai4	Beheeyem From 大 dà, 大宇 dà​yǔ, and ​怪 guài​
大针蜂[大針蜂]	da4 zhen1 feng1	Beedrill From 大 dà, 蜂針 fēngzhēn, and 蜂 fēng
大竺葵[大竺葵]	da4 zhu2 kui2	Meganium Formerly 大菊花 Dàjúhuā (TW/CN) 大菊花 Daaihgūkfā (HK) Literally "Big chrysanthemum"
大嘴蝠[大嘴蝠]	da4 zui3 fu2	Golbat Formerly 大口蝠 Daaihháufūk (HK)  Literally "Big-mouthed bat"
大嘴鸥[大嘴鷗]	da4 zui3 ou1	Pelipper Literally "Big-mouthed gull"
大嘴雀[大嘴雀]	da4 zui3 que4	Fearow Formerly 魔雀 Mōjéuk (HK)  Means "Big-mouthed sparrow"
大嘴娃[大嘴娃]	da4 zui3 wa2	Mawile Literally "Big-mouthed doll"
呆呆兽[呆呆獸]	dai1dai1 shou4	Slowpoke Formerly 小呆獸 Síungòihsau (HK)  Means "Slow-witted creature"
呆呆王[呆呆王]	dai1dai1 wang2	Slowking Formerly 河馬王 / 河马王 Hémǎwáng (TW/CN) 河馬王 Hòhmáhwòhng (HK) Literally "Hippopotamus king"
呆火驼[呆火駝]	dai1 huo3 tuo2	Numel Literally "Slow-witted fire camel"
呆壳兽[呆殼獸]	dai1 ke2 shou4	Slowbro Formerly 呆河馬 / 呆河马 Dāihémǎ (TW/CN) 大呆獸 Daaihngòihsau (HK) Means "Slow-witted hippopotamus"
代拉基翁[代拉基翁]	dai4 la1 ji1 weng1	Terrakion Transliteration of Japanese name
代欧奇希斯[代歐奇希斯]	dai4 ou1 qi2 Xi1si1	Deoxys Transliteration of its Japanese name.
戴鲁比[戴魯比]	dai4 lu3 bi3	Houndour Transliteration of its Japanese name
袋兽[袋獸]	dai4shou4	Kangaskhan Formerly 袋龍 / 袋龙 Dàilóng (TW/CN)  From 袋鼠 dàishǔ, 袋 dài, and 龍 lóng
单卵细胞球[單卵細胞球]	dan1 luan3xi4bao1 qiu2	Solosis From 單 dān, 卵 luǎn, 細胞 xìbāo, and 球 qiú
单首龙[單首龍]	dan1 shou3 long2	Deino Literally "Single headed dragon"
胆小虫[膽小蟲]	dan3xiao3 chong2	Wimpod From 膽小 / 胆小 dǎnxiǎ and 蟲 / 虫 chóng
蛋蛋[蛋蛋]	dan4dan4	Exeggcute Same as Cantonese name.
灯火幽灵[燈火幽靈]	deng1huo3 you1ling2	Lampent From 燈火 dēnghuǒ and 幽靈 yōulíng
灯笼鱼[燈籠魚]	deng1long2yu2	Chinchou Literally "Lantern fish"
灯罩夜菇[燈罩夜菇]	deng1zhao4 ye4 gu1	Shiinotic From 燈罩 / 灯罩 dēngzhào, 夜 yè, and 蘑菇 mógū
滴蛛[滴蛛]	di1 zhu1	Dewpider From 滴 dī and 蜘蛛 zhīzhū
滴蛛霸[滴蛛霸]	di1 zhu1 ba4	Araquanid From 滴 dī, 蜘蛛 zhīzhū, and 霸 bà
地幔岩[地幔岩]	di4man4 yan2	Boldore From 地幔 dìmàn and 岩 yán.
地鼠[地鼠]	di4 shu3	Diglett Literally "Ground rodent", but also refers to the mole. Can also be a reference to 打地鼠 Dǎ Dìshǔ
帝王拿波[帝王拿波]	di4wang2 na2 bo1	Empoleon From 帝王 dìwáng, 帝王企鵝 dìwáng qì'é, the first characters of 拿破崙·波拿巴 Ná​pò​lún​ Bō​ná​bā, and 波 bō
帝牙海狮[帝牙海獅]	di4 ya2 hai3shi1	Walrein Literally "King(-sized)-tusked sea lion".
帝牙卢卡[帝牙盧卡]	di4 ya2 Lu2ka3	Dialga Transliteration of Japanese name
蒂安希[蒂安希]	di4 an1 xi1	Diancie Transliteration of its Japanese name
电灯怪[電燈怪]	dian4deng1 guai4	Lanturn Literally "Lamp freak".
电电虫[電電蟲]	dian4 dian4 chong2	Joltik From 電 diàn and 蟲 chóng
电飞鼠[電飛鼠]	dian4 fei1shu3	Emolga Formerly 導電飛鼠 / 导电飞鼠 Dǎodiànfēishǔ (TW/CN) 導電飛鼠 Douhdihnfēisyú (HK) From 導電 dǎodiàn and 飛鼠 fēishǔ
电击怪[電擊怪]	dian4ji1 guai4	Elekid Literally "Electric shock freak"
电击魔兽[電擊魔獸]	dian4ji1 mo2 shou4	Electivire Literally "Electric shock magical beast"
电击兽[電擊獸]	dian4ji1 shou4	Electabuzz Literally "Electric shock beast"
电龙[電龍]	dian4 long2	Ampharos From the Japanese 電竜 denryū, literally meaning electric dragon
电束木[電束木]	dian4 shu4 mu4	Xurkitree From 電 / 电 diàn, 束 shù and 樹木 / 树木 shùmù
电萤虫[電螢蟲]	dian4 ying2 chong2	Volbeat Literally "Electric firefly"
电蜘蛛[電蜘蛛]	dian4 zhi1zhu1	Galvantula Literally "Electric spider"
蝶结萌虻[蝶結萌虻]	die2 jie2 meng2 meng2	Ribombee From 蝴蝶結 / 蝴蝶结 húdiéjié, 萌え moe, and 蜂虻 fēngméng
东施喵[東施喵]	dong1 shi1 miao1	Purugly 東施 comes from the idiom 東施效顰 Dōngshī xiào pín. Its origin is about an ugly woman, who later earned the nickname "東施" for attempting to imitate 西施 Xī Shī, an extremely beautiful woman. 喵 is the onomatopoetic sound of a cat.
咚咚鼠[咚咚鼠]	Dong1dong5 shu3	Dedenne From 咚咚 dōng​dōng​ and 鼠 shǔ
冻原熊[凍原熊]	dong4yuan2 xiong2	Beartic Literally "Tundra bear"
斗笠菇[斗笠菇]	dou3li4 gu1	Breloom From 斗笠 dǒulì and 菇 gū
豆豆鸽[豆豆鴿]	dou4dou5 ge1	Pidove From the Japanese 豆 mame and 鴿 gē.
嘟嘟[嘟嘟]	du1du1	Doduo Formerly 多多 Dōdō (HK)  Transliteration of its Japanese name. 嘟嘟鳥 Dūdū-niǎo is also a name for the dodo bird
嘟嘟利[嘟嘟利]	du1du1 li4	Dodrio Formerly 多多利 Dōdōleih (HK)  Transliteration of its Japanese name. 嘟嘟鳥 Dūdū-niǎo is also a name for the dodo bird
毒贝比[毒貝比]	du2 bei4 bi3	Poipole From 毒 dú and a transliteration of baby
毒刺水母[毒刺水母]	du2ci4 shui3mu3	Tentacruel Formerly 多腳水母 Dōgeukséuimóuh (HK)  Literally "Venomous sting jellyfish"
毒粉蛾[毒粉蛾]	du2 fen3 e2	Dustox Formerly 毒粉蝶 Dúfěndié (TW/CN) 毒粉蝶 Duhkfandihp (HK) Literally "Toxic dust butterfly"
毒骷蛙[毒骷蛙]	du2 ku1 wa1	Toxicroak 毒骷 may be a transliteration of "doku" in its Japanese name. 毒 also means poison. The last character means frog. Literally "Poison skeleton frog".
毒蔷薇[毒薔薇]	du2 qiang2wei1	Roselia Literally "Poisonous rose"
毒藻龙[毒藻龍]	du2 zao3 long2	Dragalge Formerly 毒拉蜜妮 Dúlāmìní (TW) 毒拉蜜妮 Duhklāaimahtnèih (HK) Partial transliteration of its Japanese name. Contains 毒 dú and 泥 nī
独剑鞘[獨劍鞘]	du2 jian4qiao4	Honedge From 獨 dú, 劍 jiàn, and 鞘 qiào
独角虫[獨角蟲]	du2 jiao3 chong2	Weedle Literally "Single-horned bug"
独角犀牛[獨角犀牛]	du2 jiao3 xi1niu2	Rhyhorn Formerly 鐵甲犀牛 / 铁甲犀牛 Tiějiǎxīniú (TW/CN) 鐵甲犀牛 Titgaapsāingàuh (HK) Means "Armored rhinoceros"
盾甲茧[盾甲繭]	dun4 jia3 jian3	Cascoon Literally "Shielded cocoon"
盾甲龙[盾甲龍]	dun4 jia3 long2	Shieldon From 盾 dùn, 甲 jiǎ, and 龍 lóng
顿甲[頓甲]	dun4 jia3	Donphan Formerly 冬凡 Dūngfàahn (HK)  From 頓 dùn and 甲 jiǎ
多边兽[多邊獸]	duo1bian1 shou4	Porygon Formerly 3D龍 / 3D龙 3D-Lóng (TW/CN) 立方獸 Laahpfōngsau (HK) Literally "3D Dragon"
多边兽Ⅱ[多邊獸Ⅱ]	duo1bian1 shou4	Porygon2 Formerly 3D龍ＩＩ / 3D龙ＩＩ 3D-Lóng II (TW/CN) 立方獸ＩＩ Laahpfōngsau II (HK) Literally "3D Dragon II"
多边兽Ｚ[多邊獸Ｚ]	duo1bian1 shou4Ｚ	Porygon-Z Formerly 3D龍Z / 3D龙Z 3D-Lóng Z (TW/CN) 立方獸Z Laahpfōngsau-Z (HK) Literally "3D Dragon Z"
多刺菊石兽[多刺菊石獸]	duo1 ci4 ju2shi2 shou4	Omastar Means "Spiky ammonite beast"
多多冰[多多冰]	duo1duo1 bing1	Vanillish From 多多 duōduō and 冰 bīng
多丽米亚[多麗米亞]	duo1 li4 mi3 ya4	Furfrou Transliteration of Japanese name. Contains 麗 / 丽 lì
恶食大王[惡食大王]	e4shi2 da4wang2	Guzzlord From 惡 / 恶 è, 食 shí, and 大王 dàwáng
饭匙蛇[飯匙蛇]	fan4 chi2 she2	Seviper Means "Spoon-shaped snake"
芳香精[芳香精]	fang1xiang1 jing1	Aromatisse 
霏欧纳[霏歐納]	fei1 ou1 na4	Phione Transliteration of Japanese name
飞天螳螂[飛天螳螂]	fei1tian1 tang2lang2	Scyther Means "Flying mantis"
飞腿郎[飛腿郎]	fei1tui3 lang2	Hitmonlee Formerly 沙瓦郎 Shāwǎláng (TW/CN) 沙古拉 Sāgúlāai (HK) Partial transliteration of its Japanese name. The character 郎 refers to young males
费洛美螂[費洛美螂]	fei4 Luo4mei3 lang2	Pheromosa From 費洛蒙 / 费洛蒙 fèiluòméng, 美 měi, and 蟑螂 zhāngláng
粉蝶虫[粉蝶蟲]	fen3die2 chong2	Scatterbug Formerly 粉蛹 Fěnyǒng (TW) 粉蛹 Fányúng (HK) From 鱗粉 línfěn and 蛹 yǒng
粉蝶蛹[粉蝶蛹]	fen3 die2yong3	Spewpa From 鱗粉 línfěn, 蝶 dié, and 蛹 yǒng
粉香香[粉香香]	fen3 xiang1xiang1	Spritzee From 粉撲 fěn, 粉紅 fěnhóng, and 香 xiāng
蜂女王[蜂女王]	feng1 nü3wang2	Vespiquen Formerly 蜂后 Fēnghòu (TW/CN) 蜂后 Fūnghauh (HK) Literally "Bee queen"
风铃铃[風鈴鈴]	feng1 ling2ling2	Chimecho From 風鈴 fēnglíng and 鈴 líng
风速狗[風速狗]	feng1su4 gou3	Arcanine Formerly 奉神犬 Fuhngsàhnhyún (HK)  Literally "Wind speed dog"
风妖精[風妖精]	feng1 yao1jing5	Whimsicott From 風 / 风 fēng and 妖精 yāojing
凤王[鳳王]	feng4 wang2	Ho-Oh Formerly 鳳凰 Fuhngwòhng (HK)  Literally "Phoenix king"
佛烈托斯[佛烈托斯]	fo2 lie4 tuo1 si1	Forretress Formerly 佛烈託斯 Fúliètuōsī (TW) 佛烈託斯 Fahtlihttoksī (HK) Transliteration of its Japanese name
浮潜鼬[浮潛鼬]	fu2qian2 you4	Floatzel Formerly —  Literally "Snorkeling weasel". Also, 浮 refers to floating, while 潛 refers to diving.
斧牙龙[斧牙龍]	fu3 ya2 long2	Fraxure Literally "Axe-tusked dragon"
负电拍拍[負電拍拍]	fu4dian4 pai1 pai5	Minun Literally "Negative charge clapping"
嘎啦嘎啦[嘎啦嘎啦]	ga1la5 ga1la5	Marowak Formerly 嘎拉嘎拉 Gālāgālā (TW/CN) 格拉格拉 Gaaklāaigaaklāai (HK) Transliteration of Japanese name. 嘎拉嘎拉 also refers to a rattling sound.
盖盖虫[蓋蓋蟲]	gai4 gai4 chong2	Karrablast From 蓋 gài and 蟲 chóng
盖诺赛克特[蓋諾賽克特]	gai4 nuo4 sai4 ke4 te4	Genesect Transliteration of Japanese name
盖欧卡[蓋歐卡]	gai4 ou1 ka3	Kyogre Transcription of its Japanese name
钢炮臂虾[鋼炮臂蝦]	gang1pao4 bi4 xia1	Clawitzer 
高傲雉鸡[高傲雉雞]	gao1ao4 zhi4ji1	Unfezant Formerly 轟隆雉雞 / 轰隆雉鸡 Hōnglóngzhìjī (TW/CN) 轟隆雉雞 Gwàhnglùhngjihgāi (HK) From 轟隆 hōnglóng and 雉雞 zhìjī.
哥达鸭[哥達鴨]	ge1 da2 ya1	Golduck Formerly 高超鴨 Gōuchīu'aap (HK)  Partial transliteration of Golduck. 哥 is also composed of 2 可, possibly a reference to 可達鴨 Kědáyā. The last character means duck
哥德宝宝[哥德寶寶]	ge1 de2 bao3bao5	Gothita From 哥德 gēdé and 寶寶 bǎobǎo
哥德小姐[哥德小姐]	ge1 de2 xiao3jie3	Gothitelle From 哥德 Gēdé and 小姐 xiǎojiě
哥德小童[哥德小童]	ge1 de2 xiao3tong2	Gothorita From 哥德 Gēdé and 小童 xiǎotóng
耿鬼[耿鬼]	geng3 gui3	Gengar Transliteration of its Japanese name. Contains 鬼
功夫鼬[功夫鼬]	Gong1 Fu1 you4	Mienfoo Literally "Kung-Fu weasel"
勾魂眼[勾魂眼]	gou1hun2 yan3	Sableye From 勾魂 gōuhún and 眼 yǎn
勾帕路翁[勾帕路翁]	gou1 pa4 lu4 weng1	Cobalion Transliteration of Japanese name
呱呱泡蛙[呱呱泡蛙]	gu1gu1 pao4 wa1	Froakie From 呱呱 guāguā, 泡 pào, and 蛙 wā
呱头蛙[呱頭蛙]	gu1 tou2 wa1	Frogadier From 呱 guā, 頭 tóu, and 蛙 wā
咕咕[咕咕]	gu1gu1	Hoothoot Refers to the onomatopoetic sound of birds (coo). Also means "to mutter".
咕咕鸽[咕咕鴿]	gu1gu1 ge1	Tranquill Formerly 波波鴿 / 波波鸽 Bōbōgē (TW/CN) 波波鴿 Bōbōgap (HK) 波 bō may be from the Japanese 波 ha or transliteration of boh in its Japanese name. 鴿 gē means "dove" or "pigeon". May also be a reference to 波波 (Pidgey).
咕妞妞[咕妞妞]	gu1 niu1niu1	Whismur Literally "Murmuring girl". Also phonetically similar to its Japanese name
古空棘鱼[古空棘魚]	gu3 kong1 ji2yu2	Relicanth 古 means ancient. 空棘魚 may be derived from 腔棘魚 Qiāngjíyú.
固拉多[固拉多]	gu4 la1 duo1	Groudon Transcription of its Japanese name. 固 also means "solid"
聒噪鸟[聒噪鳥]	gua1 zao4 niao3	Chatot Literally "Clamorous/noisy bird".
怪颚龙[怪顎龍]	guai4 e4 long2	Tyrantrum 
怪力[怪力]	guai4li4	Machamp Means "Bewildering strength" or "Monster strength"
光电伞蜥[光電傘蜥]	guang1dian4 san3 xi1	Heliolisk Formerly 電傘查特 Diànsǎnchátè (TW) 電傘查特 Dihnsaanchàhdahk (HK) From 電 diàn, 傘蜥蜴 sǎnxīyì, and 查特 chátè
龟脚脚[龜腳腳]	gui1 jiao3 jiao3	Binacle 
龟足巨铠[龜足巨鎧]	gui1 zu2 ju4 kai3	Barbaracle From 龜足 guīzú, 巨鎧 jùkǎi, and 鎧茗荷科 Kǎimínghé-kē
鬼斯[鬼斯]	gui3 si1	Gastly Transliteration of Japanese name. Also from 鬼 and 瓦斯.
鬼斯通[鬼斯通]	gui3 si1 tong1	Haunter Rough transcription of its Japanese name. Also a combination of 鬼, 瓦斯, and 通.
混混鳄[混混鱷]	gun3 gun3 e4	Krokorok From 混混 hùnhùn and 鱷 è.
滚滚蝙蝠[滾滾蝙蝠]	gun3gun3 bian1fu2	Woobat From 滾滾 gǔngǔn and 蝙蝠 biānfú.
果然翁[果然翁]	guo3ran2 weng1	Wobbuffet From 果然 guǒrán and 不倒翁 bùdǎowēng
过动猿[過動猿]	guo4 dong4 yuan2	Vigoroth Literally "Hyperactive ape"
哈克龙[哈克龍]	ha1 ke4 long2	Dragonair Formerly 哈古龍 Hāgúlùhng (HK)  A combination of 哈克 hākè and 龍 lóng
哈力栗[哈力栗]	ha1 li4 li4	Chespin Formerly 哈力馬龍 Hālihkmáhlùhng (HK)  From 哈力 hālì and 栗 ​lì
哈约克[哈約克]	ha1 Yue1ke4	Herdier From 哈 hā and 約克夏犬 Yuēkèxià Quǎn.
海豹球[海豹球]	hai3bao4 qiu2	Spheal From its Japanese name. Literally "Seal sphere"
海刺龙[海刺龍]	hai3 ci4 long2	Seadra Formerly 飛刺海馬 Fēichihóimáh (HK)  Literally "Sea sting dragon". May also come from 海龍科 Hǎilóng-kē.
海魔狮[海魔獅]	hai3 mo2 shi1	Sealeo From its Japanese name. Combination of 海獅 and 魔術師 Mó​shù​shī.
海兔兽[海兔獸]	hai3tu4 shou4	Gastrodon Formerly 海牛獸 / 海牛兽 Hǎiniúshòu (TW/CN) 海牛兽 Hóingàuhsau (HK) Literally "Manatee beast"
海星星[海星星]	hai3 xing1xing5	Staryu From 海星 and 星星
含羞苞[含羞苞]	han2xiu1 bao1	Budew Literally "Shy bud".
豪力[豪力]	hao2 li4	Machoke Formerly 大力 Daaihlihk (HK)  Literally "Heroic strength"
好坏星[好壞星]	hao3-huai4 xing1	Mareanie From 好壞 / 好坏 hǎohuài and 海星 hǎixīng
好啦鱿[好啦魷]	hao3 la5 you2	Inkay Formerly 豪喇花枝 Háolǎhuāzhī (TW) 毫喇魷 Hòuhlāyàuh (HK) From 好啦 hǎo la and 花枝 huāzhī
好胜毛蟹[好勝毛蟹]	hao4sheng4 mao2xie4	Crabominable From 好勝 / 好胜 hàoshèng and 毛蟹 máoxiè
好胜蟹[好勝蟹]	hao4sheng4 xie4	Crabrawler From 好勝 / 好胜 hàoshèng and 蟹 xiè
河马兽[河馬獸]	he2ma3 shou4	Hippowdon Literally "Hippopotamus beast".
赫拉克罗斯[赫拉克羅斯]	He4la1 ke4 Luo2si1	Heracross Formerly 赫拉剋羅斯 Hèlākèluósī (TW) 赫拉剋羅斯 Hāklāaihāklòhsī (HK) Transliteration of its Japanese name. Also from 赫拉克勒斯 Hèlākèlèsī.
黑暗鸦[黑暗鴉]	hei1an4 ya1	Murkrow From 黑暗 hēi'àn and 鴉 / 鸦 yā
黑鲁加[黑魯加]	hei1 lu3 jia1	Houndoom Transliteration of its Japanese name
黑眼鳄[黑眼鱷]	hei1 yan3 e4	Sandile From 黑眼 hēiyǎn and 鱷 / 鳄 è
黑夜魔灵[黑夜魔靈]	hei1ye4 mo2 ling2	Dusknoir Formerly 夜黑魔人 Yèhēimórén (TW/CN) 夜黑魔人 Yehhākmōyàhn (HK) Literally "Night sorcerer"
猴怪[猴怪]	hou2 guai4	Mankey Literally "Monkey monster"
吼爆弹[吼爆彈]	hou3 bao4dan4	Loudred Literally "Howling bomb"
吼吼鲸[吼吼鯨]	hou3 hou3 jing1	Wailmer Literally "Bellowing whale"
吼鲸王[吼鯨王]	hou3 jing1 wang2	Wailord Literally "Bellowing whale king"
壶壶[壺壺]	hu2 hu2	Shuckle Repetition of the character 壺 hú. Also from 藤壺 ténghú
胡地[胡地]	hu2 di4	Alakazam Formerly 富迪 Fudihk (HK)  Transliteration of its Japanese name. Also similar to 胡迪尼.
胡帕[胡帕]	hu2 pa4	Hoopa Transliteration of its Japanese name. Contains 胡 hú.
护城龙[護城龍]	hu4 cheng2 long2	Bastiodon From 護 hù, 城 chéng, and 龍 lóng
花蓓蓓[花蓓蓓]	hua1 bei4 bei4	Flabébé Similar to its Japanese name. Also from 花 huā and 蓓 bèi
花洁夫人[花潔夫人]	hua1 jie2 fu1ren5	Florges From 花 huā, 潔 / 洁 jié, and 夫人 fūrén
花疗环环[花療環環]	hua1 liao2 huan2 huan2	Comfey From 花環 / 花环 huāhuán and 療法 liáofǎ
花舞鸟[花舞鳥]	hua1 wu3 niao3	Oricorio From 花舞 huāwǔ and 鳥 niǎo
花岩怪[花岩怪]	hua1 yan2 guai4	Spiritomb From 花崗岩 and 怪物. 花岩 can also mean "flower-patterned rock".
花漾海狮[花漾海獅]	hua1 yang4 hai3shi1	Brionne From 花樣 / 花样 huāyàng, 漾 yàng, and 海獅 / 海狮 hǎishī
花椰猴[花椰猴]	hua1 ye1 hou2	Pansage From 青花椰菜 qīng huāyécài or 花椰菜 huāyécài and 猴 hóu.
花椰猿[花椰猿]	hua1 ye1 yuan2	Simisage From 青花椰菜 qīng huāyécài or 花椰菜 huāyécài and 猿 yuán.
花叶蒂[花葉蒂]	hua1ye4 di4	Floette Similar to its Japanese name. Also from 花 huā, 葉 / 叶 yè, and 蒂 dì
滑滑小子[滑滑小子]	hua2 hua2 xiao3zi5	Scraggy Formerly 滑頭小子/ 滑头小子 Huátóuxiǎozi (TW/CN) 滑頭小子 Waahttáusíují (HK) From 滑頭 huátóu and 小子 xiǎozi
化石盔[化石盔]	hua4shi2 kui1	Kabuto Formerly 萬年蟲 Maahnnìhnchùhng (HK)  Literally "Fossil helmet"
化石翼龙[化石翼龍]	hua4shi2 yi4long2	Aerodactyl Formerly 化石飛龍 Fasehkfēilùhng (HK)  Literally "Fossil pterodactyl"
晃晃斑[晃晃斑]	huang4huang5 ban1	Spinda From 晃 huàng and 斑 bān
灰尘山[灰塵山]	hui1chen2 shan1	Garbodor Literally "Dust mountain"
火斑喵[火斑喵]	huo3 ban1 miao1	Litten From 火 huǒ, 虎斑貓 / 虎斑猫 hǔbānmāo, and 喵 miāo
火暴猴[火爆猴]	huo3bao4 hou2	Primeape Literally "Fire bursting monkey"
火暴兽[火爆獸]	huo3bao4 shou4	Typhlosion Formerly 火暴獸 Huǒbàoshòu (TW) 火暴獸 Fóbouhsau (HK) Literally "Fiery violent beast"
火红不倒翁[火紅不倒翁]	huo3hong2 bu4dao3weng1	Darumaka From 火 huǒ, 紅 hóng, 火紅 huǒhóng, and 不倒翁 bùdǎowēng
火狐狸[火狐狸]	huo3 hu2li5	Fennekin From 火 huǒ and 狐狸 húlí
火箭雀[火箭雀]	huo3jian4 que4	Fletchinder From 火 huǒ, 箭 jiàn, 火箭 huǒjiàn, and 雀 què
火恐龙[火恐龍]	huo3 kong3long2	Charmeleon Literally "Fiery dinosaur"
火球鼠[火球鼠]	huo3qiu2 shu3	Cyndaquil Literally "Fireball rodent"
火神蛾[火神蛾]	Huo3shen2 e2	Volcarona Formerly 火神蟲 / 火神虫 Huǒshén​chóng (TW/CN) 火神蟲 Fósàhnchùhng (HK) From 火神 huǒshén and 蟲 chóng
火岩鼠[火岩鼠]	huo3 yan2 shu3	Quilava Means "Magma rodent"
火炎狮[火炎獅]	huo3 yan2 shi1	Pyroar From 火炎 huǒyán and 獅 shī
火焰鸡[火焰雞]	huo3yan4 ji1	Blaziken Literally "Blazing chicken"
火焰鸟[火焰鳥]	huo3yan4 niao3	Moltres Formerly 火鳥 Fóníuh (HK)  Literally "Flaming bird"
火伊布[火伊布]	huo3 yi1 bu4	Flareon Formerly 火精靈 / 火精灵 Huǒjīnglíng (TW/CN) 水伊貝 Fóyībui (HK) Means "Fire spirit". Ends with -精靈 / -精灵 like every Eeveelution in Mandarin
火稚鸡[火稚雞]	huo3 zhi4ji1	Torchic Literally "Fire chick"
基格尔德[基格爾德]	ji1 ge2 Er3de2	Zygarde Transliteration of its Japanese name
基拉祈[基拉祈]	ji1 la1 qi2	Jirachi Transliteration of its Japanese name. In addition, 祈 means "to pray"
吉利蛋[吉利蛋]	ji2li4 dan4	Chansey Literally "Lucky egg"
急冻鸟[急凍鳥]	ji2 dong4 niao3	Articuno Literally "Quick-freezing bird"
几何雪花[幾何雪花]	ji3he2 xue3hua1	Cryogonal From 幾何學 jǐ​hé​xué​ and 雪花 xuěhuā
骑士蜗牛[騎士蝸牛]	ji4 shi4 gua1niu2	Escavalier From 騎士 qíshì and 蝸牛 / 蜗牛 guāniú / wōniú
甲贺忍蛙[甲賀忍蛙]	jia3 he4 ren3 wa1	Greninja From 甲賀流 Jiǎhè-liú, 忍者 rěnzhě, and 蛙 wā
甲壳茧[甲殼繭]	jia3ke2 jian3	Silcoon Formerly 甲殼蛹 / 甲壳蛹 Jiǎkéyǒng / Jiǎqiàoyǒng (TW/CN) 甲殼蛹 Gaaphokyúng (HK) Literally "Shelled chrysalis"
甲壳龙[甲殼龍]	jia3ke2 long2	Shelgon Literally "Shelled dragon".
坚盾剑怪[堅盾劍怪]	jian1 dun4 jian4 guai4	Aegislash From 堅 / 坚 jiān, 盾 dùn, 劍 / 剑 jiàn, and 怪 guài
坚果哑铃[堅果啞鈴]	jian1guo3 ya3ling2	Ferrothorn From 堅果 jiānguǒ and 啞鈴 yǎlíng
尖牙笼[尖牙籠]	jian1ya2 long2	Carnivine Literally "Sharp-teethed cage"
尖牙陆鲨[尖牙陸鯊]	jian1ya2 lu4 sha1	Gabite Literally "Sharp-teethed land shark"
毽子草[毽子草]	jian4zi5 cao3	Hoppip Literally Shuttlecock grass
毽子花[毽子花]	jian4zi5 hua1	Skiploom Literally "Shuttlecock flower"
毽子棉[毽子棉]	jian4zi5 mian2	Jumpluff Formerly 毽子綿 / 毽子绵 Jiànzǐmián (TW/CN) 毽子綿 Yínjímìhn (HK) Literally "Shuttlecock floss"
狡猾天狗[狡猾天狗]	jiao3hua2 tian1gou3	Shiftry Literally "Crafty tengu"
角金鱼[角金魚]	jiao3 jin1yu2	Goldeen Formerly 獨角金魚 Duhkgokgāmyú (HK)  Literally "Horned goldfish"
捷克罗姆[捷克羅姆]	Jie2ke4 luo2 mu3	Zekrom Transliteration of Japanese name
捷拉奥拉[捷拉奧拉]	jie2 la1 ao4 la1	Zeraora Transliteration of Japanese name
杰尼龟[傑尼龜]	jie2 ni2 gui1	Squirtle Formerly 車厘龜 Chēléigwāi (HK)  Partial transliteration of its Japanese name. The last character in the name means turtle
结草贵妇[結草貴婦]	jie2cao3 gui4fu4	Wormadam Combination of 結草蟲 Jié​cǎochóng and 貴婦. Literally "Weaved grass madam".
结草儿[結草兒]	jie2cao3 r5	Burmy From 結草蟲 / 结草虫jié​cǎochóng and 兒 / 儿 ér
金属怪[金屬怪]	jin1shu3 guai4	Metang Literally "Metal monster".
金鱼王[金魚王]	jin1yu2 wang2	Seaking Literally "Goldfish king"
惊角鹿[驚角鹿]	jing1 jiao3 lu4	Stantler Literally "Frightening-antler deer", referring to its ability to create frightening illusions with its antlers
九尾[九尾]	jiu3wei3	Ninetales Literally means "Nine tails"
狙射树枭[狙射樹梟]	ju1 she4 shu4 xiao1	Decidueye From 狙射 jūshè, 樹 / 树 shù, 梟 / 枭 xiāo
驹刀小兵[駒刀小兵]	ju1 dao1 xiao3 bing1	Pawniard From the Japanese 駒 koma, 刀 dāo, 小 xiǎo and 兵 bīng
菊草叶[菊草葉]	ju2 cao3 ye4	Chikorita From 菊苣, 草, and 葉
菊石兽[菊石獸]	ju2shi2 shou4	Omanyte Means "Ammonite beast"
具甲武者[具甲武者]	ju4 jia3 wu3 zhe3	Golisopod From 具甲 jùjiǎ and 武者 wǔzhě
巨翅飞鱼[巨翅飛魚]	ju4 chi4 fei1yu2	Mantine From 巨翅 jùchì and 飛魚 / 飞鱼 fēiyú
巨金怪[巨金怪]	ju4 jin1 guai4	Metagross Literally "Giant gold monster" or "giant metal monster".
巨蔓藤[巨蔓藤]	ju4 man4teng2	Tangrowth From 巨 jù and 蔓藤 mànténg
巨钳螳螂[巨鉗螳螂]	ju4 qian2 tang2lang2	Scizor Means "Giant-pincered mantis"
巨钳蟹[巨鉗蟹]	ju4 qian2 xie4	Kingler Means "Crab with giant pincers"
巨牙鲨[巨牙鯊]	ju4ya2sha1	Sharpedo Literally "Giant-teethed shark"
巨沼怪[巨沼怪]	ju4 zhao3 guai4	Swampert Literally "Giant swamp monster"
卷卷耳[捲捲耳]	juan3 juan3 er3	Buneary Literally "Rolled-up ears".
掘地兔[掘地兔]	jue2di4 tu4	Diggersby Formerly 攉土兔 Huōtǔtù (TW) 攉地兔 Fokdeihtou (HK) From 攉 huō, 土 tǔ, and 兔 tù
掘掘兔[掘掘兔]	jue2 jue2 tu4	Bunnelby From 掘 jué and 兔 tù
君主蛇[君主蛇]	jun1zhu3 she2	Serperior Literally "Monarch snake".
卡比兽[卡比獸]	ka3 bi3 shou4	Snorlax From 卡比 and 獸
卡蒂狗[卡蒂狗]	ka3 di4 gou3	Growlithe Formerly 護主犬 Wuhjyúhyún (HK)  Transliteration of Gardie. The last character means dog
卡拉卡拉[卡拉卡拉]	ka3la1 ka3la1	Cubone Formerly 可拉可拉 Kělākělā (TW/CN)  Transliteration of Japanese name
卡咪龟[卡咪龜]	ka3 mi1 gui1	Wartortle Formerly 卡美龜 Kāméihgwāi (HK)  Partial transliteration of the Japanese name. The last character means turtle
卡璞・蝶蝶[卡璞・蝶蝶]	ka3 pu2・ die2 die2	Tapu Lele From kapu and 蝶 dié
卡璞・鸣鸣[卡璞・鳴鳴]	ka3 pu2・ ming2 ming2	Tapu Koko From kapu and 鳴 / 鸣 míng
卡璞・哞哞[卡璞・哞哞]	ka3 pu2・ mou1 mou1	Tapu Bulu From kapu and 哞 mōu
卡璞・鳍鳍[卡璞・鰭鰭]	ka3 pu2・ qi2 qi2	Tapu Fini From kapu and 鰭 / 鳍 qí
凯路迪欧[凱路迪歐]	kai3 lu4 di2 ou1	Keldeo Transliteration of Japanese name
凯罗斯[凱羅斯]	kai3 Luo2si1	Pinsir Formerly 大甲 Dàjiǎ (TW/CN) 鉗刀甲蟲 Kìhmdōugaapchùhng (HK) Literally "Big armor"
凯西[凱西]	kai3 xi1	Abra Formerly 卡斯 Kāsī (HK)  Transliteration of Japanese name. May also refer to 愛德加·凱西 Àidéjiā Kǎixi.
科斯莫古[科斯莫古]	ke1 si1 mo4 gu3	Cosmog Transliteration of Japanese name
科斯莫姆[科斯莫姆]	ke1 si1 mo4 mu3	Cosmoem Transliteration of Japanese name
可达鸭[可達鴨]	ke3da2 ya1	Psyduck Formerly 傻鴨 Sòh'aap (HK)  Partial transliteration of Koduck. The last character means duck
可多拉[可多拉]	ke3 duo1 la1	Lairon Transliteration of its Japanese name
可可多拉[可可多拉]	ke3ke3 duo1 la1	Aron Transliteration of its Japanese name
克雷色利亚[克雷色利亞]	ke4 lei2 se4 li4 ya4	Cresselia Transliteration of Japanese name
肯泰罗[肯泰羅]	ken3 Tai4luo2	Tauros Formerly 大隻牛 Daaihjekngàuh (HK)  Transliteration of Japanese name
口呆花[口呆花]	kou3 dai1 hua1	Weepinbell Literally means "Vacant-looking mouth flower"
哭哭面具[哭哭面具]	ku1 ku1 mian4ju4	Yamask Literally "Weeping mask"
酷豹[酷豹]	ku4 bao4	Liepard Literally "Ruthless leopard".
快龙[快龍]	kuai4 long2	Dragonite Formerly 啟暴龍 Káibouhlùhng (HK)  Transliteration of its Japanese name, literally "Fast dragon".
快拳郎[快拳郎]	kuai4 quan2 lang2	Hitmonchan Formerly 艾比郎 Àibǐláng (TW/CN) 比華拉 Béiwàhlāai (HK) Partial transliteration of Japanese name. The character 郎 refers to young males
盔甲鸟[盔甲鳥]	kui1jia3 niao3	Skarmory Literally "Armored bird"
绿毛虫[綠毛蟲]	lü4 mao2chong2	Caterpie Green caterpillar, or literally, "Green furry worm"
垃垃藻[垃垃藻]	la1 la1 zao3	Skrelp From 垃圾 lèsè and 藻 zǎo
拉达[拉達]	La1da2	Raticate Formerly 哥達 Gōdaaht (HK)  Transliteration of Japanese name
拉帝欧斯[拉帝歐斯]	la1 di4 ou1 si1	Latios Transcription of its Japanese name
拉帝亚斯[拉帝亞斯]	la1 di4 ya4 si1	Latias Transliteration of its Japanese name
拉鲁拉丝[拉魯拉絲]	La1lu3 la1si1	Ralts Transliteration of its Japanese name
拉普拉斯[拉普拉斯]	La1pu3la1si1	Lapras Formerly 乘龍 / 乘龙 Chénglóng (TW/CN) 背背龍 Buibuilùhng (HK) Means "Riding dragon", but is literally "To ride on a dragon"
喇叭芽[喇叭芽]	la3ba5 ya2	Bellsprout Literally "Trumpet sprout"
喇叭啄鸟[喇叭啄鳥]	la3ba5 zhuo2 niao3	Trumbeak From 喇叭 lǎbā and 啄木鳥 / 啄木鸟 zhuómùniǎo
莱希拉姆[萊希拉姆]	lai2 xi1 la1 mu3	Reshiram Formerly 雷希拉姆 Léixīlāmǔ (TW/CN) 雷希拉姆 Lèuihhēilāaimóuh (HK) Transliteration of Japanese name
兰螳花[蘭螳花]	lan2 tang2 hua1	Lurantis From 蘭花 / 兰花 lánhuā and 螳螂 tángláng or 蘭花螳螂 / 兰花螳螂 lánhuā tángláng
蓝蟾蜍[藍蟾蜍]	lan2 chan2chu2	Palpitoad Literally "Blue toad".
蓝鳄[藍鱷]	lan2 e4	Croconaw Means "Blue crocodilian"
懒人獭[懶人獺]	lan3ren2 ta3	Slakoth Formerly 懶人翁 / 懒人翁 Lǎnrénwēng (TW/CN) 懶人翁 Láahnyàhnyūng (HK) From 樹懶 shùlǎn, 懶人 lǎnrén, and 懶翁 lǎnwēng
老翁龙[老翁龍]	lao3weng1 long2	Drampa From 老翁 lǎowēng and 龍 lóng
乐天河童[樂天河童]	le4tian1 He2tong2	Ludicolo From 樂天 lètiān, 河 hé, 童 tóng, and 河童 hétóng, literally "happy kappa"
勒克猫[勒克貓]	le4 ke4 mao1	Luxio From 勒克斯 lèkèsī and 貓 māo
肋骨海龟[肋骨海龜]	le4 gu3 hai3gui1	Carracosta From 肋骨 lèigǔ and 海龜 hǎiguī
雷电斑马[雷電斑馬]	lei2dian4 ban1ma3	Zebstrika From 雷電 léidiàn and 斑馬 bānmǎ.
雷电兽[雷電獸]	lei2dian4 shou4	Manectric From 雷電 léidiàn, the Japanese 雷獣 raijū, and 獸 shòu
雷电云[雷電雲]	lei2dian4 yun2	Thundurus Means "Lightning cloud"
雷公[雷公]	Lei2gong1	Raikou From 雷公 Raikou. Also a reference to the ancient Chinese god of thunder, Lei Gong.
雷吉艾斯[雷吉艾斯]	lei2 ji2 ai4 si1	Regice Transliteration of its Japanese name.
雷吉洛克[雷吉洛克]	lei2 ji2 luo4 ke4	Regirock Transliteration of its Japanese name.
雷吉奇卡斯[雷吉奇卡斯]	lei2 ji2 qi2 ka3 si1	Regigigas Transliteration of Japanese name
雷吉斯奇鲁[雷吉斯奇魯]	lei2 ji2 si1 qi2 lu3	Registeel Transliteration of its Japanese name.
雷丘[雷丘]	lei2 qiu1	Raichu Formerly 雷超 Lèuihchīu (HK)  Transliteration of its Japanese name, also 雷 léi means "thunder"
雷伊布[雷伊布]	lei2 yi1 bu4	Jolteon Formerly 雷精靈 / 雷精灵 Léijīnglíng (TW/CN) 雷伊貝 Lèuihyībui (HK) Means "Thunder spirit". Ends with -精靈 / -精灵 like every Eeveelution in Mandarin
垒磊石[壘磊石]	lei3 lei3 shi2	Stakataka From 壘 / 垒 lěi, 壘壘 / 垒垒 lěilěi, 磊磊 lěilěi, and 石 shí
冷水猴[冷水猴]	leng3 shui3hou2	Panpour From 冷水 lěngshuǐ and 猴 hóu.
冷水猿[冷水猿]	leng3shui3 yuan2	Simipour From 冷水 lěngshuǐ and 猿 yuán.
鲤鱼王[鯉魚王]	li3yu2 wang2	Magikarp Literally "Carp king"
利欧路[利歐路]	li4 ou1 lu4	Riolu Formerly 利奧路 Leih'oulouh (HK)  Transliteration of Japanese name
利牙鱼[利牙魚]	li4 ya2 yu2	Carvanha Literally "Sharp-teethed fish"
力壮鸡[力壯雞]	li4zhuang4 ji1	Combusken Literally "Powerful chicken"
莲帽小童[蓮帽小童]	lian2 mao4 xiao3tong2	Lombre Literally "Lotus hat lad"
莲叶童子[蓮葉童子]	lian2ye4 tong2zi3	Lotad Literally "Lotus leaf lad"
镰刀盔[鐮刀盔]	lian2dao1 kui1	Kabutops Formerly 鐮刀蟲 Lìhmdōuchùhng (HK)  Literally "Sickle helmet"
烈箭鹰[烈箭鷹]	lie4 jian4 ying1	Talonflame Formerly 烈箭鶲 Lièjiànwēng (TW)  From 烈 liè, 箭 jiàn, and 鶲 wēng
烈空坐[烈空坐]	lie4 kong1 zuo4	Rayquaza From its Japanese name. Can also be taken as "one who sits in the fierce heavens".
烈雀[烈雀]	lie4 que4	Spearow Formerly 鬼雀 Gwáijéuk (HK)  Means "Fierce sparrow"
烈焰猴[烈焰猴]	lie4yan4 hou2	Infernape Literally "Raging flame monkey".
烈焰马[烈焰馬]	lie4yan4 ma3	Rapidash Means "Raging flame horse" or "Horse of roaring flames"
烈咬陆鲨[烈咬陸鯊]	lie4 yao3 lu4 sha1	Garchomp Literally "Violent biting land shark"
猎斑鱼[獵斑魚]	lie4 ban1 yu2	Huntail From its Japanese name. Combination of 獵, 斑點, and 魚. Literally "Hunting speckled fish".
鳞甲龙[鱗甲龍]	lin2jia3 long2	Hakamo-o From 鱗甲/ 鳞甲 línjiǎ and 龍 / 龙 lóng
铃铛响[鈴鐺響]	ling2dang5 xiang3	Chingling Formerly 鈴噹響 Língdāngxiǎng (TW) 鈴噹響 Lìhngdōnghéung (HK) From 鈴 líng, 噹 dāng, and 響 xiǎng
流氓鳄[流氓鱷]	liu2mang2 e4	Krookodile From 流氓 liúmáng and 鱷 è.
流氓熊猫[流氓熊貓]	liu2mang2 xiong2mao1	Pangoro From 流氓 liúmáng and 熊貓 xióngmāo
六尾[六尾]	liu4 wei3	Vulpix Literally means "Six tails"
溜溜糖球[溜溜糖球]	liu4liu5 tang2 qiu2	Surskit Means "Skating candy"
隆隆石[隆隆石]	long2long2 shi2	Graveler Formerly 滾動石 Gwánduhngsehk (HK)  Literally "Rumbling rock"
隆隆岩[隆隆岩]	long2long2 yan2	Golem Formerly 滾動岩 Gwánduhngngàahm (HK)  Literally "Rumbling boulder"
龙卷云[龍捲雲]	long2 juan3yun2	Tornadus Means "Tornado cloud"
龙头地鼠[龍頭地鼠]	long2tou2 di4 shu3	Excadrill From the Japanese 竜頭 ryūzu, 地 dì, 鼠 shǔ, and 地鼠 dìshǔ.
龙王蝎[龍王蠍]	Long2wang2 xie1	Drapion Literally "Dragon king scorpion".
龙虾小兵[龍蝦小兵]	long2xia1 xiao3 bing1	Corphish From 龍蝦 lóngxiā, 小龍蝦 xiǎo​lóng​xiā, and 小兵 xiǎobīng
路卡利欧[路卡利歐]	lu4qia3 li4 ou1	Lucario Formerly 路卡利奧 Louhkāleih'ou (HK)  Transliteration of Japanese name
露力丽[露力麗]	lu4 li4 li4	Azurill Transliteration of its Japanese name. Also contains 露 lù
露奈雅拉[露奈雅拉]	lu4 nai4 ya3 la1	Lunala Transliteration of Japanese name
伦琴猫[倫琴貓]	lun2qin2 mao1	Luxray From 倫琴 Lúnqín and 貓 māo
罗丝雷朵[羅絲雷朵]	luo2 si1 lei2 duo3	Roserade Transliteration of its Japanese name. The last character 朵 is also a classifier for flowers.
螺钉地鼠[螺釘地鼠]	luo2ding1 di4 shu3	Drilbur From 螺釘 luódīng, 地 dì, 鼠 shǔ, and 地鼠 dìshǔ.
洛奇亚[洛奇亞]	luo4 qi2 ya4	Lugia Formerly 利基亞 Leihgēi'a (HK)  Transliteration of its Japanese name
洛托姆[洛托姆]	luo4 tuo1 mu3	Rotom Transliteration of Japanese name
落雷兽[落雷獸]	luo4lei2 shou4	Electrike From the Japanese 落雷 rakurai and 雷獣 raijū.
麻麻鳗[麻麻鰻]	ma2 ma2 man2	Eelektrik From 麻 má and 鰻 mán
麻麻鳗鱼王[麻麻鰻魚王]	ma2 ma2 man2yu2 wang2	Eelektross From 麻 má, 鰻魚 mányú, and 王 wáng
麻麻小鱼[麻麻小魚]	ma2 ma2 xiao3yu2	Tynamo From 麻 má, 小 xiǎo​, and 魚 yú
玛机雅娜[瑪機雅娜]	ma3 ji1 ya3 nuo2	Magearna Transliteration of its Japanese name. Contains 機 / 机 jī
玛力露[瑪力露]	ma3 li4 lu4	Marill Formerly 馬利露 Máhleihlouh (HK)  Transliteration of its Japanese name. Also contains 露 lù
玛力露丽[瑪力露麗]	ma3 li4 lu4 li4	Azumarill Formerly 馬利露麗 Máhleihlouhlaih (HK)  Transliteration of its Japanese name. Also contains 露 lù
玛纳霏[瑪納霏]	ma3 na4 fei1	Manaphy Transliteration of Japanese name
玛瑙水母[瑪瑙水母]	ma3nao3 shui3mu3	Tentacool Formerly 大眼水母 Daaihngáahnséuimóuh (HK)  Literally "Agate jellyfish"
玛狃拉[瑪狃拉]	ma3 niu3 la1	Weavile Transliteration of its Japanese name.
玛沙那[瑪沙那]	ma3 Sha1na4	Meditite Rough transliteration of its Japanese name
玛夏多[瑪夏多]	ma3 xia4 duo1	Marshadow Transliteration of Japanese name
蔓藤怪[蔓藤怪]	man4teng2 guai4	Tangela Formerly 長籐怪 Chèuhngtàhnggwaai (HK)  Literally "Vine freak"
猫老大[貓老大]	mao1 lao3da4	Persian Formerly 高竇貓 Gōudauhmāau (HK)  貓 means cat, while 老大 can also refer to boss
猫头夜鹰[貓頭夜鷹]	mao1 tou2 ye4ying1	Noctowl Combination of 貓頭鷹 and 夜鷹. Literally "Cat-headed night hawk".
猫鼬少[貓鼬少]	mao1you4 shao3	Yungoos From 貓鼬 / 猫鼬 māoyòu and 少 shào or 惡少 / 恶少 èshào
猫鼬探长[貓鼬探長]	mao1you4 tan4zhang3	Gumshoos From 貓鼬 / 猫鼬 māoyòu and 探長 / 探长 tànzhǎng
猫鼬斩[貓鼬斬]	mao1you4 zhan3	Zangoose From 貓鼬 māoyòu and 斬 zhǎn
毛球[毛球]	mao2 qiu2	Venonat Formerly 毛毛蟲 Mòuhmòuhchùhng (HK)  Literally "Fur ball"
毛头小鹰[毛頭小鷹]	mao2tou2 xiao3 ying1	Rufflet Literally "Feather-headed eaglet"
煤炭龟[煤炭龜]	mei2tan4 gui1	Torkoal Literally "Coal tortoise"
美丽花[美麗花]	mei3li4 hua1	Bellossom Literally "Beautiful flower"
美录梅塔[美錄梅塔]	mei3 lu4 mei2 ta3	Melmetal Transliteration of Japanese name. The character 錄 lù (to record) contains the radical 金 (metal).
美录坦[美錄坦]	mei3 lu4 tan3	Meltan Transliteration of Japanese name. The character 錄 lù (to record) contains the radical 金 (metal).
美洛耶塔[美洛耶塔]	mei3 luo4 ye2 ta3	Meloetta Transliteration of Japanese name
美纳斯[美納斯]	mei3 na4 si1	Milotic From 美 měi and 維納斯 Wéi​nà​sī
魅力喵[魅力喵]	mei4li4 miao1	Glameow From 魅力 and 喵.
萌虻[萌虻]	meng2 meng2	Cutiefly From 萌え moe and 蜂虻 fēngméng
萌芽鹿[萌芽鹿]	meng2ya2 lu4	Sawsbuck Formerly 芽吹鹿 Yáchuīlù (TW/CN) 芽吹鹿 Ngàhchēuilúk (HK) From the Japanese 芽吹き mebuki and 鹿 lù
猛火猴[猛火猴]	meng3 huo3hou2	Monferno Literally "Fierce fire monkey"
梦歌仙人掌[夢歌仙人掌]	meng4 ge1 xian1ren2zhang3	Cacturne Formerly 夢歌奈亞 / 梦歌奈亚 Mènggēnàiyǎ / Mènggēnàiyà (TW/CN) 夢歌奈亞 Muhnggōnoih'a (HK) From 夢歌 mènggē and 奈亞 nàiyǎ
梦幻[夢幻]	meng4huan4	Mew Formerly 夢夢 Muhngmuhng (HK)  Means "dream" or "illusion"
梦梦蚀[夢夢蝕]	meng4meng4 shi2	Musharna Similar to Munna's Chinese name 食夢夢 Shímèngmèng. 蝕 shí can also refer to "eclipse".
梦妖[夢妖]	meng4 yao1	Misdreavus From 夢 mèng and 妖 yāo
梦妖魔[夢妖魔]	meng4 yao1mo2	Mismagius From 夢 mèng, 夢妖 Mèngyāo, 夢魔 mèngmó, and 妖魔 yāomó
谜拟Ｑ[謎擬Ｑ]	mi2 ni3 	Mimikyu From 謎 / 谜 mí, 模擬 / 模拟 mónǐ, and Q
迷唇姐[迷唇姐]	mi2 chun2 jie3	Jynx Formerly 紅唇娃 Hùhngsèuhnwā (HK)  Literally "Bewildering lip lady"
迷唇娃[迷唇娃]	mi2 chun2 wa2	Smoochum Literally "Bewildering lip doll"
迷你冰[迷你冰]	mi2ni3 bing1	Vanillite From 迷你 mínǐ and 冰 bīng
迷你龙[迷你龍]	mi2ni3 long2	Dratini Literally "Mini dragon"
绵绵泡芙[綿綿泡芙]	mian2mian2 pao4fu2	Swirlix From 棉花糖 miánhuātáng, 綿 mián, and 泡芙 pàofú
喵喵[喵喵]	miao1 miao1	Meowth Formerly 喵喵怪 Mēumēugwaai (HK)  喵 miāo is the sound a cat makes, pronounced like "meow"From 喵 miāo and 貓 māo
妙喵[妙喵]	miao4 miao1	Espurr From 妙 miào and 喵 miāo
妙蛙草[妙蛙草]	miao4 wa1 cao3	Ivysaur Formerly 奇異草 Kèihyihchóu (HK)  Literally "Wonderful frog grass"
妙蛙花[妙蛙花]	miao4 wa1 hua1	Venusaur Formerly 奇異花 Kèihyihfā (HK)  Literally "Wonderful frog flower"
妙蛙种子[妙蛙種子]	miao4 wa1 zhong3zi5	Bulbasaur Formerly 奇異種子 Kèihyihjúngjí (HK)  Literally "Wonderful frog seed"
咩利羊[咩利羊]	mie1 li4 yang2	Mareep From 咩 miē, 瑪莉 Mǎlì, and 羊 yáng
敏捷虫[敏捷蟲]	min3jie2 chong2	Accelgor From 敏捷 mǐnjié and 蟲 chóng
摩鲁蛾[摩魯蛾]	mo2 lu3 e2	Venomoth Formerly 末入蛾 Mòrù'é (TW/CN) 魔魯風 Mōlóuhfūng (HK) From 末入 mòrù and 蛾 é. May also be from 粉末 fěnmò
磨牙彩皮鱼[磨牙彩皮魚]	mo2ya2 cai3 pi2 yu2	Bruxish From 磨牙 móyá, 彩 cǎi, 皮 pí, and 魚 / 鱼 yú
蘑蘑菇[蘑蘑菇]	mo2 mo2gu5	Shroomish From 蘑菇 mógū with the first character repeated
魔尼尼[魔尼尼]	mo2 ni2 ni2	Mime Jr. Transliteration of its Japanese name. 魔 also means magic.
魔墙人偶[魔牆人偶]	mo2 qiang2 re2nou3	Mr. Mime Formerly 吸盤魔偶 / 吸盘魔偶 Xīpánmó'ǒu (TW/CN) 吸盤小丑 Kāppúnsíucháu (HK) From 吸盤 xīpán and 魔偶 mó'ǒu
墨海马[墨海馬]	mo4hai3 ma3	Horsea Formerly 噴墨海馬 Panmahkhóimáh (HK)  Literally "Ink seahorse"
姆克鸟[姆克鳥]	mu3 ke4 niao3	Staravia Transliteration of its Japanese name. The last character means "bird".
姆克儿[姆克兒]	mu3 ke4 r5	Starly Transliteration of its Japanese name. The last character means "child".
姆克鹰[姆克鷹]	mu3 ke4 ying1	Staraptor Transliteration of its Japanese name. The last character means hawk/falcon/eagle.
幕下力士[幕下力士]	mu4 xia4 li4shi4	Makuhita From 幕下 makushita and 力士 lìshì
木棉球[木棉球]	mu4 mian2qiu2	Cottonee From 木棉 mùmián and 棉球 miánqiú.
木木枭[木木梟]	mu4 mu4 xiao1	Rowlet From 木 mù and 梟 / 枭 xiāo
木守宫[木守宮]	mu4 shou3gong1	Treecko Means "Wood gecko"
奈克洛兹玛[奈克洛茲瑪]	nai4 ke4 luo4 zi1 ma3	Necrozma Transliteration of Japanese name
南瓜怪人[南瓜怪人]	nan2gua5 guai4ren2	Gourgeist From 南瓜 nánguā and 怪人 gwaaiyàhn
南瓜精[南瓜精]	nan2gua5 jing1	Pumpkaboo From 南瓜 nánguā and 精 jīng
尼多后[尼多后]	ni2 duo1 hou4	Nidoqueen Formerly 尼美后 Nèihméihhauh (HK)  A portmanteau of 尼多, the common prefix of the names of this Pokémon's evolutionary line, and 后 hòu
尼多兰[尼多蘭]	ni2 duo1 lan2	Nidoran♀ Formerly 尼美蘭 Nèihméihlàahn (HK)  Transliteration of Japanese name. The character 蘭 is usually used in female names
尼多朗[尼多朗]	ni2 duo1 lang3	Nidoran♂ Formerly 尼多郎 Nèihdōlòhng (HK)  Transliteration of its Japanese name. 朗 Láng is a word usually used in transliterating male names
尼多力诺[尼多力諾]	ni2 duo1 li4 nuo4	Nidorino Formerly 尼多利 Nèihdōleih (HK)  Transliteration of Japanese name. 力 lì means power, strength
尼多娜[尼多娜]	ni2 duo1 nuo2	Nidorina Formerly 尼美蘿 Nèihméihlòh (HK)  Rough transliteration of Japanese name. 娜 Nà is a word usually used in transliterating female names
尼多王[尼多王]	ni2 duo1 wang2	Nidoking A portmanteau of 尼多, the common prefix of the names of this Pokémon's evolutionary line, and 王 wáng
泥巴鱼[泥巴魚]	ni2ba1 yu2	Stunfisk Literally "Mud fish"
泥驴仔[泥驢仔]	ni2 lü2 zi3	Mudbray From 泥 ní, 驢子 lǘzi, and 仔 zǎi
泥泥鳅[泥泥鰍]	ni2 ni2qiu5	Barboach From 泥 ní and 泥鰍 níqiū
泥偶巨人[泥偶巨人]	ni2 ou3 ju4ren2	Golurk From 泥人 nírén, 偶人 ǒurén, and 巨人 jùrén
泥偶小人[泥偶小人]	ni2 ou3 xiao3ren2	Golett From 泥人 nírén, 偶人 ǒurén, and 小 xiǎo
霓虹鱼[霓虹魚]	ni2hong2 yu2	Lumineon From 霓虹燈 / 霓虹灯 ní​hóng​dēng or 霓虹燈魚 / 霓虹灯鱼 ní​hóng​dēngyú and 魚 / 鱼 yú
鲶鱼王[鯰魚王]	nian2yu2 wang2	Whiscash Literally "Catfish king"
黏美龙[黏美龍]	nian2 mei3 long2	Goodra Formerly 黏美露龍 Niánměilùlóng (TW)  From 黏 nián, 美 měi, and 龍 / 龙 lóng; transliteration of its Japanese name
黏美儿[黏美兒]	nian2 mei3 r5	Sliggoo Formerly 黏美伊兒 Niánměiyī'er (TW)  From 黏 nián, 美 měi, and 兒 / 儿 er; transliteration of its Japanese name
黏黏宝[黏黏寶]	nian2 nian2 bao3	Goomy From 黏 nián and 寶寶 / 宝宝 bǎobǎo
念力土偶[念力土偶]	nian4li4 tu3ou3	Claydol From 念力 niànlì and 土偶 tǔ'ǒu
狃拉[狃拉]	niu3 la1	Sneasel Transliteration of its Japanese name
暖暖猪[暖暖豬]	Nuan3nuan3 zhu1	Tepig From 暖 nuǎn and 豬 zhū.
扒手猫[扒手貓]	pa2shou3 mao1	Purrloin Literally "Pickpocket cat".
帕路奇亚[帕路奇亞]	pa4 lu4 qi2 ya4	Palkia Formerly 帕路奇犽 Pàlùqíyá (TW/CN) 帕路奇犽 Paaklouhkèingàh (HK) Transliteration of Japanese name
帕奇利兹[帕奇利茲]	pa4 qi2 Li4zi1	Pachirisu Transliteration of Japanese name
派拉斯[派拉斯]	pai4 la1 si1	Paras Formerly 蘑菇蟲 Mòhgūchùhng (HK)  Transliteration of Japanese name
派拉斯特[派拉斯特]	pai4 la1 si1 te4	Parasect Formerly 巨菇蟲 Mòuhmòuhchùhng (HK)  Transliteration of Japanese name
庞岩怪[龐岩怪]	pang2 yan2 guai4	Gigalith Literally "Gigantic boulder monster".
彷徨夜灵[彷徨夜靈]	pang2huang2 ye4 ling2	Dusclops Formerly 夜巨人 Yèjùrén (TW/CN) 夜巨人 Yehgeuihyàhn (HK) Literally "Night giant"
胖丁[胖丁]	pang4 ding1	Jigglypuff Formerly 波波球 Bōbōkàuh (HK)  From 胖 pàng and 布丁 bùdīng
胖嘟嘟[胖嘟嘟]	pang4du1du1	Jellicent Means "plump" or "pudgy"
胖可丁[胖可丁]	pang4 ke3 ding1	Wigglytuff Formerly 肥波球 Fèihbōkàuh (HK)  Possibly a corrupted transliteration of its Japanese name. Also from 胖 pàng and 布丁 bùdīng
胖胖哈力[胖胖哈力]	pang4 pang4 ha1 li4	Quilladin Formerly 肥仔哈力 Fèihjáihālihk (HK)  From 胖胖 pàngpàng and 哈力栗 Hāllì​lì
胖甜妮[胖甜妮]	pang4 tian2 ni1	Slurpuff From 胖 pàng, 甜 tián, and 妮 ní
泡沫栗鼠[泡沫栗鼠]	pao4mo4 li4shu3	Minccino From 泡沫 pàomò and 栗鼠 lìshǔ
喷火龙[噴火龍]	pen1 huo3long2	Charizard Literally "Fire-breathing dragon"
喷火驼[噴火駝]	pen1huo3 tuo2	Camerupt Literally "Fire-breathing camel"
喷嚏熊[噴嚏熊]	pen1ti4 xiong2	Cubchoo Literally "Sneezing bear"
盆才怪[盆才怪]	pen2 cai2guai4	Bonsly Formerly 愛哭樹 / 爱哭树 Àikūshù (TW/CN) 愛哭樹 Oihūksyuh (HK) From 盆栽 pénzāi, 才怪 cáiguài, and 怪兽 guàiwù / 怪物 guàishòu.Literally "Crybaby tree".
砰头小丑[砰頭小丑]	peng1 tou2 xiao3chou3	Blacephalon From 砰 pēng, 頭 / 头 tóu, and 小丑 xiǎochǒu
劈斩司令[劈斬司令]	pi1 zhan3 si1ling4	Bisharp From 劈 pī, 斬 zhǎn, and 司令 sīlìng
霹雳电球[霹靂電球]	pi1li4 dian4 qiu2	Voltorb Formerly 雷電球 / 雷电球 Léidiànqiú (TW/CN) 霹靂蛋 Pīklīkdáan (HK) Literally "Thunder and lightning sphere"
皮宝宝[皮寶寶]	pi2 bao3bao5	Cleffa From 皮 pí and 寶寶 băobăo
皮卡丘[皮卡丘]	pi2ka3 qiu1	Pikachu Formerly 比卡超 Béikāchīu (HK)  Transliteration of its Japanese name.
皮可西[皮可西]	pi2 ke3 xi1	Clefable Formerly 皮可斯 Pèihhósī (HK)  Transliteration of Japanese name
皮皮[皮皮]	pi2 pi2	Clefairy Transliteration of Japanese name
皮丘[皮丘]	pi2 qiu1	Pichu Formerly 比超 Béichīu (HK)  Transliteration of its Japanese name.
飘浮泡泡[飄浮泡泡]	piao1fu2 pao1 pao1	Castform Formerly 漂浮泡泡 Piāofúpàopào (TW/CN) 漂浮泡泡 Pīufàuhpóuhpóuh (HK) From 飄浮 piāofú and 泡泡 pàopàoFrom 漂浮 piāofú and 泡泡 pàopào
飘飘球[飄飄球]	piao1piao1 qiu2	Drifloon Literally "Lightly floating balloon". 球 is derived from 氣球 Qì​qiú.
破破袋[破破袋]	po4 po4 dai4	Trubbish Possibly derived from the Japanese name. 破 means "damaged" or "worn out". 袋 means "bag".
破破舵轮[破破舵輪]	po4 po4 duo4lun2	Dhelmise From 破 pò and 舵輸 / 舵轮 duòlún
噗噗猪[噗噗豬]	pu1 pu1 zhu1	Grumpig Literally means "Puffing pig"
七夕青鸟[七夕青鳥]	qi1xi1 qing1niao3	Altaria From 七夕 Qīxì and 青鳥 Qīngniǎo. The Qixi Festival originated from the tale of The Weaver Girl and the Cowherd, a love story featuring two characters symbolized by the stars Altair and Vega.
奇鲁莉安[奇魯莉安]	qi2 lu3 li4 an1	Kirlia Transliteration of its Japanese name. May also be from 克里安 Kèlǐ'ān
奇诺栗鼠[奇諾栗鼠]	qi2 nuo4 li4shu3	Cinccino From 奇諾 qínuò and 栗鼠 lìshǔ. May also be from 卡布奇諾 Kǎ​bù​qí​nuò
骑拉帝纳[騎拉帝納]	qi2 la1 di4 na4	Giratina Transliteration of Japanese name
麒麟奇[麒麟奇]	qi2lin2 qi2	Girafarig From 麒麟 Qílín and 奇 qí. The name will sound the same when read in reverse
恰雷姆[恰雷姆]	qia4 lei2 mu3	Medicham Transliteration of its Japanese name
千针鱼[千針魚]	qian1 zhen1yu2	Qwilfish Literally "Thousand-needle fish"
钳尾蝎[鉗尾蠍]	qian2 wei3 xie1	Skorupi Formerly 紫天蠍 / 紫天蝎 Zǐtiānxiē (TW/CN) 紫天蠍 Jítīnkit (HK) Literally "Purple sky scorpion". 天蠍 also refers to the constellation Scorpius.
强颚鸡母虫[強顎雞母蟲]	qiang2 e4 ji1mu3 chong2	Grubbin From 強顎 / 强颚 qiáng'è and 雞母蟲 / 鸡母虫 jīmǔchóng
锹农炮虫[鍬農炮蟲]	qiao1 nong2 pao4 chong2	Vikavolt From 鍬形蟲 / 锹形虫 qiāoxíngchóng and 加農炮 / 加农炮 jiānóngpào
蜻蜻蜓[蜻蜻蜓]	qing1 qing1ting2	Yanma Formerly 陽陽瑪 / 阳阳玛 Yángyángmǎ (TW/CN) 阳阳玛 Yèuhngyèuhngmáh (HK) Transliteration of its Japanese name
轻飘飘[輕飄飄]	qing1piao1piao1	Frillish Means "Lightly floating"
青绵鸟[青綿鳥]	qing1 mian2 niao3	Swablu Literally "Blue cotton-flossed bird"
青藤蛇[青藤蛇]	qing1 teng2 she2	Servine Literally "Green vine snake". May also be from 常青藤 chángqīngténg.
青铜钟[青銅鐘]	qing1 tong2zhong1	Bronzong Literally "Bronze bell". 青 also means blue/green
请假王[請假王]	qing3jia4 wang2	Slaking From 請假 qǐngjià and 王 wáng
球球海狮[球球海獅]	qiu2 qiu2 hai3shi1	Popplio From 球 qiú and 海獅 / 海狮 hǎishī
酋雷姆[酋雷姆]	qiu2 lei2 mu3	Kyurem Transliteration of Japanese name
圈圈熊[圈圈熊]	quan1quan5 xiong2	Ursaring Literally "Ring bear"
拳海参[拳海參]	quan2 hai3shen1	Pyukumuku From 拳 quán and 海參 / 海参 hǎishēn
裙儿小姐[裙兒小姐]	qun2 r5 xiao3jie3	Lilligant From 裙 qún, 兒 ér, and 小姐 xiǎojiě.
燃烧虫[燃燒蟲]	ran2shao1 chong2	Larvesta From 燃燒 rán​shāo and 蟲 ​chóng​
热带龙[熱帶龍]	re4dai4 long2	Tropius Literally "Tropical dragon"
人造细胞卵[人造細胞卵]	ren2zao4 xi4bao1 luan3	Reuniclus From 人造 rénzào, 細胞 xìbāo or 細胞核 xìbāohé, and 卵 luǎn
溶食兽[溶食獸]	rong2 shi2 shou4	Gulpin Means "Digesting beast"
熔岩虫[熔岩蟲]	rong2yan2 chong2	Slugma Literally "Lava worm"
熔岩蜗牛[熔岩蝸牛]	rong2yan2 gua1niu2	Magcargo Literally "Lava snail"
熔蚁兽[熔蟻獸]	rong2 yi3 shou4	Heatmor Formerly 食蟻爐 / 食蚁炉 Shíyǐlú (TW/CN) 食蟻爐 Sihkngáihlòuh (HK) From 食蟻獸 shíyǐshòu and 爐 lú
茸茸羊[茸茸羊]	rong2rong2 yang2	Flaaffy Formerly 綿綿 / 绵绵 Miánmián (TW/CN) 綿綿 Mìhnmìhn (HK) From 綿 mián and 綿羊 mián​yáng.
弱丁鱼[弱丁魚]	ruo4 ding1 yu2	Wishiwashi From 弱 ruò and 沙丁魚 / 沙丁鱼 shādīngyú
三地鼠[三地鼠]	san1 di4 shu3	Dugtrio Formerly 三頭地鼠 Sāamtàuhdeihsyú (HK)  Literally "Three ground rodent" or "Three moles". Can also be a reference to 打地鼠 Dǎ Dìshǔ
三合一磁怪[三合一磁怪]	san1he2yi1 ci2 guai4	Magneton Literally "Three-in-one magnetic monster"
三蜜蜂[三蜜蜂]	san1 mi4feng1	Combee Literally "Three honeybees".
三首恶龙[三首惡龍]	san1 shou3e4 long2	Hydreigon Formerly 三頭龍 / 三头龙 Sāntóulóng (TW/CN) 三頭龍 Sāamtàuhlùhng (HK) Literally "Three-headed dragon"
伞电蜥[傘電蜥]	san3 dian4 xi1	Helioptile Formerly 發電蜥 Faatdihnsīk (HK)  From 傘蜥蜴 sǎnxīyì and 電 diàn
森林蜥蜴[森林蜥蜴]	sen1lin2 xi1yi4	Grovyle Literally "Forest lizard"
沙河马[沙河馬]	Sha1he2 ma3	Hippopotas Formerly 怪河馬 / 怪河马 Guàihémǎ (TW/CN) 怪河馬 Gwaaihòhmáh (HK) Literally "Strange hippopotamus".
沙基拉斯[沙基拉斯]	sha1ji1 la1 si1	Pupitar Formerly 沙基拉 Shājīlā (TW/CN) 沙基拉 Sāgēilāai (HK) Transliteration of its Japanese name. May also be from 安基拉斯 Ānjīlāsī. Contains 沙 shā
沙铃仙人掌[沙鈴仙人掌]	sha1 ling2 xian1ren2zhang3	Maractus Formerly 街頭沙鈴 / 街头沙铃 Jiētóushālíng (TW/CN) 街頭沙鈴 Gāaitàuhsālìhng (HK) From 墨西哥街頭樂隊 Mòxīgē-jiētóuyuèduì and 沙鈴 shālíng.
沙漠蜻蜓[沙漠蜻蜓]	sha1mo4 qing1ting2	Flygon Literally "Desert dragonfly"
沙奈朵[沙奈朵]	sha1 nai4 duo3	Gardevoir Transliteration of Japanese name
沙丘娃[沙丘娃]	sha1qiu1 wa2	Sandygast From 沙丘 shāqiū, 娃 wá, and 哇 wa
闪电鸟[閃電鳥]	shan3dian4 niao3	Zapdos Formerly 雷鳥 Lèuihníuh (HK)  Literally "Lightning bird"
蛇纹熊[蛇紋熊]	she2wen2 xiong2	Zigzagoon Literally "Snake-patterned bear", referring to the zigzag pattern in its fur resembling a wriggling snake
绅士蛾[紳士蛾]	shen1shi4 e2	Mothim Literally "Gentleman moth"
师父鼬[師父鼬]	shi1fu5 you4	Mienshao Literally "Master weasel"
时拉比[時拉比]	shi2 la1bi3	Celebi Formerly 雪拉比 Xuělābǐ (TW/CN) 雪拉比 Syutlāaibéi (HK) Transliteration of its Japanese name
石居蟹[石居蟹]	shi2 ju1 xie4	Dwebble Literally "Stone house crab".
石丸子[石丸子]	shi2 wan2zi5	Roggenrola Literally "Stone ball".
食梦梦[食夢夢]	shi2 meng4meng4	Munna Possibly from 食夢 shímèng (Dream Eater), with the last character repeated.
始祖大鸟[始祖大鳥]	shi3zu3 da4 niao3	Archeops From 始祖鳥 Shǐzǔniǎo and 大 dà
始祖小鸟[始祖小鳥]	shi3zu3 xiao3niao3	Archen From 始祖鳥 Shǐzǔniǎo and 小 xiǎo
噬沙堡爷[噬沙堡爺]	shi4 sha1bao3 ye2	Palossand From 吞噬 tūnshì, 沙堡 shābǎo, 爺 / 爷 yé, and 是沙堡耶 Shì shābǎo yé
狩猎凤蝶[狩獵鳳蝶]	shou4lie4 feng4die2	Beautifly From 狩獵 shòuliè and 鳳蝶 fèngdié
属性：空[屬性：空]	shu3xing4： kong1	Type: Null From 屬性 / 属性 shǔxìng and 空 kōng
树才怪‎[樹才怪]	shu4 cai2guai4‎	Sudowoodo Formerly 胡說樹 / 胡说树 Húshuōshù (TW/CN) 胡說樹 / 鬍說樹 Wùhsyutsyuh (HK) Literally "Driveling tree"
树林龟[樹林龜]	shu4lin2 gui1	Grotle Literally "Forest turtle"
树枕尾熊[樹枕尾熊]	shu4 zhen3 wei3 xiong2	Komala From 樹 shù, 無尾熊 wúwěixióng and 树袋熊 shùdàixióng, and 枕頭 / 枕头 zhěntou
摔角鹰人[摔角鷹人]	shuai1 jue2ying1 ren2	Hawlucha Formerly 戰鬥飛鳥 Zhàndòufēiniǎo (TW) 戰鬥飛鳥 Jindaufēiníuh (HK) From 戰鬥 zhàn​dòu and 飛鳥 fēi​niǎo​
双倍多多冰[雙倍多多冰]	shuang1bei4 duo1duo1 bing1	Vanilluxe From 雙倍 shuāngbèi, 多多 duōduō, and 冰 bīng
双弹瓦斯[雙彈瓦斯]	shuang1 dan4 wa3si1	Weezing Formerly 毒氣雙子 Duhkheisēungjí (HK)  Means "Double gas bomb"
双斧战龙[雙斧戰龍]	shuang1 fu3 zhan4 long2	Haxorus Literally "Double-axe battle dragon"
双剑鞘[雙劍鞘]	shuang1 jian4qiao4	Doublade From 雙 shuāng, 劍 jiàn, and 鞘 qiào
双卵细胞球[雙卵細胞球]	shuang1luan3 xi4bao1 qiu2	Duosion From 雙 shuāng, 卵 luǎn, 細胞 xìbāo, and 球 qiú
双刃丸[雙刃丸]	shuang1ren4 wan2	Dewott From 雙刃 shuāngrèn and the Japanese 丸 maru.
双首暴龙[雙首暴龍]	shuang1 shou3 bao4long2	Zweilous Formerly 雙頭龍 / 双头龙 Shuāng​tóulóng (TW/CN) 雙頭龍 Sēungtàuhlùhng (HK) Literally "Double-headed dragon"
双尾怪手[雙尾怪手]	shuang1 wei3 guai4shou3	Ambipom Literally "Double tail, strange hand", references 長尾怪手 Chángwěiguàishǒu
水箭龟[水箭龜]	shui3 jian4 gui1	Blastoise Water rocket turtle
水晶灯火灵[水晶燈火靈]	shui3jing1 deng1huo3 ling2	Chandelure From 水晶燈 / 水晶灯 shuǐjīngdēng, 燈火 / 灯火 dēnghuǒ, 火 huǒ, and 靈 / 灵 líng
水君[水君]	shui3 jun1	Suicune From 水君 Suikun.
水水獭[水水獺]	shui3 shui3ta3	Oshawott From 水 shuǐ and 水獺 shuǐtà.
水伊布[水伊布]	shui3 yi1 bu4	Vaporeon Formerly 水精靈 / 水精灵 Shuǐjīnglíng (TW/CN) 水伊貝 Séuiyībui (HK) Means "Water spirit". Ends with -精靈 / -精灵 like every Eeveelution in Mandarin.
水跃鱼[水躍魚]	shui3 yue4 yu2	Mudkip Literally "Water jumping fish"
睡睡菇[睡睡菇]	shui4 shui4 gu1	Morelull From 睡 shuì and 蘑菇 mógū
死神棺[死神棺]	si3shen2 guan1	Cofagrigus From 死神 sǐshén and 棺 guān
四颚针龙[四顎針龍]	si4 e4 zhen1 long2	Naganadel From 四 sì, 顎 / 颚 è, 針 / 针 zhēn, and 龍 / 龙  lóng
四季鹿[四季鹿]	si4ji4 lu4	Deerling From its Japanese name. Literally "Four season deer".
随风球[隨風球]	sui2feng1 qiu2	Drifblim Formerly 附和氣球 / 附和气球 Fùhèqìqiú (TW/CN) 附和氣球 Fuhwohheikàuh' (HK) From 隨風 / 随风 suífēng and 氣球 / 气球 qìqiúFrom 附和 fùhè and 氣球 / 气球 qìqiú
索尔迦雷欧[索爾迦雷歐]	Suo3er3 jia1 lei2 ou1	Solgaleo Transliteration of Japanese name
索罗亚[索羅亞]	suo3 luo2 ya4	Zorua Transliteration of Japanese name
索罗亚克[索羅亞克]	suo3 luo2 ya4 ke4	Zoroark Transliteration of Japanese name
太古盔甲[太古盔甲]	tai4gu3 kui1jia3	Armaldo Means "Immemorial armor"
太古羽虫[太古羽蟲]	tai4gu3 yu3 chong2	Anorith Means "Immemorial feathered bug"
太阳珊瑚[太陽珊瑚]	tai4yang2 shan1hu2	Corsola Literally "Sun coral"
太阳岩[太陽岩]	tai4yang2 yan2	Solrock Literally "Sun rock"
太阳伊布[太陽伊布]	tai4yang2 yi1 bu4	Espeon Formerly 太陽精靈 / 太阳精灵 Tàiyángjīnglíng (TW/CN) 太陽伊貝 Taaiyèuhngyībui (HK) Means "Sun spirit". Ends with -精靈 / -精灵 like every Eeveelution in Mandarin.
坦克臭鼬[坦克臭鼬]	tan3ke4 chou4you4	Skuntank Combination of 坦克 and 臭鼬.
探探鼠[探探鼠]	tan4 tan4 shu3	Patrat From 探 tàn and 鼠 shǔ.
藤藤蛇[藤藤蛇]	teng2 teng2 she2	Snivy From 藤 téng and 蛇 shé
天秤偶[天秤偶]	tian1cheng4 ou3	Baltoy Literally "Libra figurine"
天然鸟[天然鳥]	tian1ran2 niao3	Xatu Literally "Natural bird"
天然雀[天然雀]	tian1ran2 que4	Natu Literally "Natural sparrow".
天蝎[天蠍]	tian1xie1	Gligar Literally "Sky scorpion". May also be a reference to the constellation Scorpius
天蝎王[天蠍王]	tian1xie1 wang2	Gliscor Literally "Sky scorpion king"
甜冷美后[甜冷美后]	tian2 leng3 mei3 hou4	Tsareena From 甜 tián, 冷艷 / 冷艳 lěngyàn, 美麗 / 美丽 měilì, and 后 hòu
甜甜萤[甜甜螢]	tian2 tian2 ying2	Illumise Literally "Sweet firefly"
甜舞妮[甜舞妮]	tian2 wu3 ni1	Steenee From 甜 tián, 舞女 wǔnǚ, and 妮 ní / nī
甜竹竹[甜竹竹]	tian2 zhu2 zhu2	Bounsweet From 甜 tián and 山竹 shānzhú
跳跳猪[跳跳豬]	tiao4 tiao4 zhu1	Spoink Literally "Jumping pig"
铁螯龙虾[鐵螯龍蝦]	tie3 ao2 long2xia1	Crawdaunt From 鐵螯 tiě'áo, 龍蝦 lóngxiā, and 小龍蝦 xiǎo​lóng​xiā or 螯蝦 áoxiā
铁臂枪虾[鐵臂槍蝦]	tie3bi4 qiang1 xia1	Clauncher From 鐵臂 tiěbì, 槍 qiāng, and 槍蝦 qiāngxiā
铁骨土人[鐵骨土人]	tie3gu3 tu3ren2	Gurdurr From 鐵骨 tiěgǔ, 土 tǔ, and possibly 工人 gōngrén.
铁火辉夜[鐵火輝夜]	tie3 huo3 hui1 ye4	Celesteela From 鐵 / 铁 tiě, 火 huǒ and 輝夜姬 / 辉夜姬 Huīyè-jī
铁甲蛹[鐵甲蛹]	tie3jia3 yong3	Metapod Formerly 鐵甲蟲 Titgaapchùhng (HK)  Armored chrysalis
铁壳蛹[鐵殼蛹]	tie3 ke2 yong3	Kakuna Formerly 鐵殼昆 / 铁壳昆 Tiěkékūn (TW/CN)  From 鐵殼 tiěké and 昆蟲 kūn​chóng. 殼昆 kékūn also sounds like cocoon
铁面忍者[鐵面忍者]	tie3mian4 ren3zhe3	Ninjask Literally "Iron-masked ninja"
铁炮鱼[鐵炮魚]	tie3pao4 yu2	Remoraid From its Japanese name
铁哑铃[鐵啞鈴]	tie3 ya3ling2	Beldum Literally "Iron dumbbell".
铁蚁[鐵蟻]	tie3 yi3	Durant Literally "Iron ant"
铁掌力士[鐵掌力士]	tie3 zhang3 li4 shi4	Hariyama Formerly 超力王 Chāolìwáng (TW/CN) 超力王 Chīulihkwòhng (HK) Literally "Super-powered king"
童偶熊[童偶熊]	tong2 ou3 xiong2	Stufful From 童 tóng, 玩偶 wán'ǒu, and 熊 xióng
铜镜怪[銅鏡怪]	tong2jing4 guai4	Bronzor Literally "Bronze mirror freak".
头盖龙[頭蓋龍]	tou2gai4 long2	Cranidos From 頭蓋 tóugài and 龍 lóng
头巾混混[頭巾混混]	tou2jin1 gun3 gun3	Scrafty From 頭巾 tóujīn and 混混 hùnhùn
投摔鬼[投摔鬼]	tou2 shuai1 gui3	Throh Formerly 投射鬼 Tóushèguǐ (TW/CN) 投射鬼 Tàuhsehgwái' (HK) From 投射 tóushè and the Japanese 鬼 ki (oni).
投羽枭[投羽梟]	tou2 yu3 xiao1	Dartrix From 投 tóu, 羽 yǔ, and 梟 / 枭 xiāo
投掷猴[投擲猴]	tou2zhi4 hou2	Passimian From 投擲 / 投掷 tóuzhí / tóuzhì and 猴 hóu
秃鹰娜[禿鷹娜]	tu1ying1 nuo2	Mandibuzz From 禿鷹 tūyīng and 娜 nà
秃鹰丫头[禿鷹丫頭]	tu1ying1 ya1tou5	Vullaby Formerly 禿鷹小子 / 秃鹰小子 Tūyīngxiǎozi (TW/CN) 禿鷹小子 Tūkyīngsíují (HK) Means "Vulture child"
图图犬[圖圖犬]	tu2 tu2 quan3	Smeargle Formerly 圖畫犬 Tòuhwáhyún (HK)  Literally "Drawing dog", referring to its ability to paint
土地云[土地雲]	tu3di5 yun2	Landorus Literally "Land cloud"
土居忍士[土居忍士]	tu3 ju1 ren3 shi4	Nincada Literally "Earth-residing ninja"
土狼犬[土狼犬]	tu3 lang2quan3	Poochyena From 土狼 tǔláng and 犬 quǎn
土龙弟弟[土龍弟弟]	tu3long2 di4di5	Dunsparce From 土 tǔ, 龍 lóng, and 弟弟 dìdì
土台龟[土台龜]	tu3 tai2 gui1	Torterra Can be taken as "Earth terrace tortoise".
吞食兽[吞食獸]	tun1shi2 shou4	Swalot Means "Devouring beast"
托戈德玛尔[托戈德瑪爾]	tuo1 ge1 de2 ma3 er3	Togedemaru Transliteration of its Japanese name
脱壳忍者[脫殼忍者]	tuo1ke2 ren3zhe3	Shedinja Literally "Shedding ninja". May also be from 金蟬脫殼 Jīn​chán ​tuōké
瓦斯弹[瓦斯彈]	wa3si1dan4	Koffing Formerly 毒氣丸 Duhkheiyún (HK)  Literally "Gas bomb"
顽皮雷弹[頑皮雷彈]	wan2pi2 lei2 dan4	Electrode Formerly 頑皮彈 / 顽皮弹 Wánpídàn (TW/CN) 雷霆蛋 Lèuihtìhngdáan (HK) Literally "Naughty bomb", a reference to its facial expression
顽皮熊猫[頑皮熊貓]	wan2pi2 xiong2mao1	Pancham From 頑皮 wánpí and 熊貓 xióngmāo
腕力[腕力]	wan4li4	Machop Formerly 鐵腕 Titwún (HK)  Literally "Wrist strength"
伪螳草[偽螳草]	wei3 tang2 cao3	Fomantis From 偽 / 伪 wèi / wěi, 螳螂 tángláng, and 草 cǎo
尾立[尾立]	wei3 li4	Sentret Literally "Tail stand"
未知图腾[未知圖騰]	wei4zhi1 tu2teng2	Unown From 未知 meihjī and 圖騰 / 图腾 túténg
蚊香君[蚊香君]	wen2xiang1 jun1	Poliwhirl Formerly 蚊香蛙 Wénxiāngwā (TW/CN) 蚊香蛙 Mānhēungwā (HK) From 蚊香 and 蛙
蚊香蝌蚪[蚊香蝌蚪]	wen2xiang1 ke1dou3	Poliwag From 蚊香 and 蝌蚪
蚊香蛙皇[蚊香蛙皇]	wen2xiang1 wa1 huang2	Politoed Formerly 牛蛙君 Niúwājūn (TW/CN) 牛蛙君 Ngàuhwāgwān (HK) Literally "Bullfrog monarch"
蚊香泳士[蚊香泳士]	wen2xiang1 yong3 shi4	Poliwrath Formerly 快泳蛙 Kuàiyǒngwā (TW/CN) 大力蛙 Daaihlihkwā (HK) Literally "Fast swimming frog"
嗡蝠[嗡蝠]	weng1 fu2	Noibat From 嗡 wēng and 蝠 fú
乌波[烏波]	wu1 bo1	Wooper Transliteration of its Japanese name. Contains 波 bō
乌鸦头头[烏鴉頭頭]	wu1ya1 tou2tou5	Honchkrow Literally "Crow chief"
乌贼王[烏賊王]	wu1zei2 wang2	Malamar From 烏賊 wūzéi and 王 wáng
无壳海兔[無殼海兔]	wu2 ke2 hai3tu4	Shellos Formerly 無殼海牛 / 无壳海牛 Wúkéhǎiniú / Wúqiàohǎiniú (TW/CN) 無殼海牛 Mòuhhokhóingàuh (HK) Literally "No shell manatee".
无畏小子[無畏小子]	wu2wei4 xiao3zi5	Tyrogue Formerly 巴爾郎 / 巴尔郎 Bā'ěrláng (TW/CN) 巴爾郎 Bāyíhlòhng (HK) Partial transliteration of its Japanese name. The character 郎 refers to young males.
蜈蚣王[蜈蚣王]	wu2gong5 wang2	Scolipede From 蜈蚣 wúgōng and 王 wáng
舞天鹅[舞天鵝]	wu3 tian1e2	Swanna Formerly 首席天鵝 / 首席天鹅 Shǒuxítiān'é (TW/CN) 首席天鵝 Sáujihktīnngòh (HK) From 首席 shǒuxí and 天鵝 tiāné
蜥蜴王[蜥蜴王]	xi1yi4 wang2	Sceptile Literally "Lizard king"
西狮海壬[西獅海壬]	xi1 shi1 hai3 ren2	Primarina From 西施 Xī Shī, 海獅 / 海狮 hǎishī, and 塞壬 Sāirén or 西壬 Xīrén
席多蓝恩[席多藍恩]	xi2 duo1 lan2 en1	Heatran Transliteration of Japanese name
仙子伊布[仙子伊布]	xian1zi3 yi1 bu4	Sylveon Formerly 仙子精靈 / 仙子精灵 Xiānzǐjīnglíng (TW/CN) 仙子伊貝 Sīnjíyìhbui (HK) {{tt Means "Fairy spirit". Ends with -精靈 / -精灵 like every Eeveelution in Mandarin.
向日花怪[向日花怪]	xiang4ri4 hua1 guai4	Sunflora From 向日葵 xiàng​rì​kuí, 花 huā, and 怪 quài
向日种子[向日種子]	xiang4ri4 zhong3zi5	Sunkern From 向日葵 xiàng​rì​kuí and 種子 / 种子 zhǒngzi
向尾喵[向尾喵]	xiang4 wei3 miao1	Skitty From 向尾 xiàngwěi, 狐尾草 húwěicǎo, and 喵 miāo
橡实果[橡實果]	xiang4shi2 guo3	Seedot Literally "Acorn fruit"
象牙猪[象牙豬]	xiang4ya2 zhu1	Mamoswine From 象牙 xiàngyá and 豬 zhū​
象征鸟[象徵鳥]	xiang4zheng1 niao3	Sigilyph Literally "Symbol bird"
小磁怪[小磁怪]	xiao3 ci2 guai4	Magnemite Literally "Little magnetic monster"
小笃儿[小篤兒]	xiao3 du3 r5	Pikipek From 小兒 xiǎo'ér and 篤篤 dǔdǔ
小福蛋[小福蛋]	xiao3 fu2 dan4	Happiny Formerly 好運蛋 / 好运蛋 Hǎoyùndàn (TW/CN) 好運蛋 Hóuwahndáan (HK) From 小 xiǎo, 福 fú, and 蛋 dàn
小果然[小果然]	xiao3 guo3ran2	Wynaut Formerly 果然仔 Gwóyìhnjái (HK)  From 小 xiǎo, 果然 guǒrán and 果然翁 Guǒránwēng
小海狮[小海獅]	xiao3 hai3shi1	Seel Means "Small (or young) sea lion"
小灰怪[小灰怪]	xiao3 hui1 guai4	Elgyem Literally "Little grey freak". Possibly a reference to 小灰人 xiǎohuīrén
小火龙[小火龍]	xiao3 huo3long2	Charmander Literally "Little fiery dragon". May also be from 小龍 xiǎolóng
小火马[小火馬]	xiao3 huo3ma3	Ponyta Literally "Little fire horse"
小火焰猴[小火焰猴]	xiao3 huo3yan4 hou2	Chimchar Literally "Little flame monkey"
小箭雀[小箭雀]	xiao3 jian4 que4	Fletchling From 小 xiǎo, 箭 jiàn, and 雀 què
小锯鳄[小鋸鱷]	xiao3 ju4 e4	Totodile Means "Little saw(-toothed) crocodilian"
小卡比兽[小卡比獸]	xiao3 ka3 bi3 shou4	Munchlax Means "Little Snorlax".
小拉达[小拉達]	xiao3 la1 da2	Rattata Formerly 小哥達 Síugōdaaht (HK)  Partial transliteration of Rattata's Japanese name. Means "Little Raticate"
小猫怪[小貓怪]	xiao3mao1 guai4	Shinx Literally "Small cat freak"
小木灵[小木靈]	xiao3 mu4 ling2	Phantump 
小球飞鱼[小球飛魚]	xiao3qiu2 fei1yu2	Mantyke Literally "Small ball flying fish".
小拳石[小拳石]	xiao3 quan2 shi2	Geodude Literally "Small fist rock"
小山猪[小山豬]	xiao3 shan1zhu1	Swinub From 小 xiǎo and 山豬 shānzhū
小狮狮[小獅獅]	xiao3 shi1 shi1	Litleo From 小 xiǎo and 獅 shī
小碎钻[小碎鑽]	xiao3 sui4zuan4	Carbink From 小 xiǎo and 碎鑽 suìzuān
小小象[小小象]	xiao3xiao3 xiang4	Phanpy Literally "Little elephant"
小约克[小約克]	xiao3 Yue1ke4	Lillipup From 小 xiǎo and 約克夏犬 Yuēkèxià Quǎn.
小陨星[小隕星]	xiao3 yun3xing1	Minior From 小 xiǎo and 隕星 yǔnxīng
小嘴蜗[小嘴蝸]	xiao3 zui3 wo1	Shelmet Literally "Small-mouthed snail"
谢米[謝米]	xie4 mi3	Shaymin Formerly 潔咪 / 洁咪 Jiémī (TW/CN) 潔咪 Gitmī (HK) Transliteration of Japanese name. 潔 jié (clean) can also refer to its ability to purify the surrounding.
心蝙蝠[心蝙蝠]	xin1 bian1fu2	Swoobat From 心 xīn and 蝙蝠 biānfú.
心鳞宝[心鱗寶]	xin1 lin2 bao3	Jangmo-o From 心 xīn, 鱗 / 鳞 lín, 寶 / 宝 bǎo
信使鸟[信使鳥]	xin4shi3 niao3	Delibird Literally "Messenger bird"
幸福蛋[幸福蛋]	xing4fu2 dan4	Blissey Literally "Blessed egg"
熊宝宝[熊寶寶]	xiong2 bao3bao5	Teddiursa Literally "Bear baby"
修建老匠[修建老匠]	xiu1jian4 lao3 jiang4	Conkeldurr Formerly 修繕老頭 / 修缮老头 Xiūshànlǎotóu (TW/CN) 修繕老頭 Sāusihnlóuhtàuh (HK) From 修繕 xiūshàn and 老頭 lǎotóu.
朽木妖[朽木妖]	xiu3mu4 yao1	Trevenant From 朽木 xiǔmù and 妖 yāo
虚吾伊德[虛吾伊德]	xu1 wu2 yi1 de2	Nihilego From 虛無 / 虚无 xūwú , 吾 wú, and possibly 佛洛伊德 Fóluòyīdé / 弗洛伊德 Fúluòyīdé
雪笠怪[雪笠怪]	xue3 li4 guai4	Snover From 雪, 笠, and 怪.
雪童子[雪童子]	xue3 tong2zi3	Snorunt From its Japanese name. 童子 may also be derived from 座敷童子 zashiki warashi. Literally "Snow boy/lad"
雪妖女[雪妖女]	xue3 yao1nü3	Froslass From its Japanese name. Combination of 雪 and 妖女.
鸭宝宝[鴨寶寶]	ya1 bao3bao5	Ducklett From 鴨 yā and 寶寶 bǎobǎo
鸭嘴宝宝[鴨嘴寶寶]	ya1 zui3 bao3bao5	Magby Formerly 小鴨嘴龍 / 小鸭嘴龙 Xiǎoyāzuǐlóng (TW/CN) 小鴨嘴龍 Síuaapjéuilùhng (HK) Literally "Duck-billed fiery dragon"
鸭嘴火兽[鴨嘴火獸]	ya1 zui3 huo3 shou4	Magmar Formerly 鴨嘴火龍 / 鸭嘴火龙 Yāzuǐhuǒlóng (TW/CN) 鴨嘴火龍 Aapjéuifólùhng (HK) Literally "Duck-billed fiery dragon"
鸭嘴炎兽[鴨嘴炎獸]	ya1 zui3 yan2 shou4	Magmortar Formerly 鴨嘴焰龍 / 鸭嘴焰龙 Yāzuǐyànlóng (TW/CN) 鴨嘴焰龍 Aapjéuiyihmlùhng (HK) Literally "Duck-billed flaming dragon"
牙牙[牙牙]	ya2ya2	Axew 牙 yá doubled
亚克诺姆[亞克諾姆]	ya4 ke4 nuo4 mu3	Azelf Transliteration of Japanese name
岩殿居蟹[岩殿居蟹]	yan2 dian4 ju1 xie4	Crustle From 岩 yán, 殿 diàn, 居 jū, and 蟹 xiè.
岩狗狗[岩狗狗]	yan2 gou3 gou3	Rockruff From 岩 yán and 狗狗 gǒugǒu
炎帝[炎帝]	Yan2di4	Entei From 炎帝 Entei. Also a reference to the ancient Chinese emperor, Yandi
炎热喵[炎熱喵]	yan2re4 miao1	Torracat From 炎熱 / 炎热 yánrè and 喵 miāo
炎武王[炎武王]	yan2 Wu3 Wang2	Emboar From its Japanese name. May be taken as a reference to 周武王 (King Wu of Zhou).
焰后蜥[焰后蜥]	yan4 hou4 xi1	Salazzle From 焰 yàn, 艷后 yànhòu, and 火蜥蜴 huǒxīyì
妖火红狐[妖火紅狐]	yao1 huo3 hong2hu2	Delphox From 妖狐yāohú, 火紅 huǒhóng, and 紅狐 hónghú
摇篮百合[搖籃百合]	yao2lan2 bai3he2	Cradily From 搖籃 / 摇篮 yáolán and 百合 bǎihé
钥圈儿[鑰圈兒]	yao4 quan1r5	Klefki Formerly 鎖圈兒 Sóhyūnyìh (HK)  From 鑰匙圈 yàoshíquān  and 兒 ér
椰蛋树[椰蛋樹]	ye1 dan4 shu4	Exeggutor Formerly 椰樹獸 Yèhsyuhsau (HK)  From 椰子 yézi / yēzi, 蛋 dàn, and 樹 / 树 shù
野蛮鲈鱼[野蠻鱸魚]	ye3man2 lu2yu2	Basculin Formerly 勇士鱸魚 / 勇士鲈鱼 Yǒngshìlúyú (TW/CN) 勇士鱸魚 Yúhngsihlòuhyú (HK) From 野蠻 yěmán and 鱸魚 lúyúFrom 勇士 yǒngshì and 鱸魚 lúyú
叶伊布[葉伊布]	ye4 yi1 bu4	Leafeon Formerly 葉精靈 / 叶精灵 Yèjīnglíng (TW/CN) 葉伊貝 Yihpyìhbui (HK) Means "Leaf spirit". Ends with -精靈 / -精灵 like every Eeveelution in Mandarin.
夜盗火蜥[夜盜火蜥]	ye4dao4 huo3 xi1	Salandit From 夜盜 / 夜盗 yèdào, 火 huǒ, and 火蜥蜴 huǒxīyì
夜巡灵[夜巡靈]	ye4 xun2 ling2	Duskull Formerly 夜骷顱 / 夜骷颅 Yèkūlú (TW/CN) 夜骷顱 Yehfūlòuh (HK) Means "Night skull"
伊布[伊布]	yi1 bu4	Eevee Formerly 伊貝 Yībui (HK)  Transliteration of its Japanese name
伊裴尔塔尔[伊裴爾塔爾]	yi1 pei2 er3 ta3 er3	Yveltal Formerly 伊秘魯塔路 Yībeilóuhtaaplouh (HK)  Transliteration of Japanese name
音波龙[音波龍]	yin1bo1 long2	Noivern Formerly 音波飛龍 Yāmbōfēilùhng (HK)  From 音波 yīnbō  and 龍 lóng 
音箱蟀[音箱蟀]	yin1xiang1 shuai4	Kricketune Literally "Soundbox/speaker cricket". 蟀 is derived from 蟋蟀 Xī​shuài.
银伴战兽[銀伴戰獸]	yin2 ban4 zhan4 shou4	Silvally From 銀 yín, 伴 bàn, 戰鬥 zhàndòu, and 獸 shòu
引梦貘人[引夢貘人]	yin3 meng4 mo4 ren2	Hypno Formerly 素利拍 Sùlìpāi (TW/CN) 催眠獸 Chēuimìhnsau (HK) Transliteration of Japanese name
樱花宝[櫻花寶]	ying1hua1 bao3	Cherubi Literally "Cherry blossom treasure". 寶 can also be derived from 寶貝 Bǎo​bèi.
樱花儿[櫻花兒]	ying1hua1 r5	Cherrim From 櫻花 / 樱花 yīnghuā and 兒 / 儿 ér
樱花鱼[櫻花魚]	ying1hua1 yu2	Gorebyss Literally "Cherry blossom fish".
荧光鱼[螢光魚]	ying2guang1 yu2	Finneon Formerly 萤光鱼 Yíngguāngyú (CN)  螢光 may be derived from 熒光 Yíng​guāng. The last character means fish.
勇基拉[勇基拉]	yong3 ji1 la1	Kadabra Formerly 勇吉拉 Yǒngjílā (TW/CN) 尤基納 Yàuhgēinaahp (HK) Transliteration of Japanese name
勇士雄鹰[勇士雄鷹]	yong3shi4 xiong2ying1	Braviary Formerly 勇士鷹 / 勇士鹰 Yǒngshìyīng (TW/CN) 勇士鷹 Yúhngsihyīng (HK) Literally "Warrior eagle"
泳圈鼬[泳圈鼬]	yong3 quan1 you4	Buizel Formerly 泳氣鼬 / 泳气鼬 Yǒngqìyòu (TW/CN) 泳氣鼬 Wihngheiyauh (HK) 泳 refers to swimming. 氣 may come from 氣力 Qì​lì. 鼬 means weasel.
优雅猫[優雅貓]	you1ya3 mao1	Delcatty Literally "Graceful cat"
由克希[由克希]	you2 ke4 xi1	Uxie Transliteration of Japanese name
幼基拉斯[幼基拉斯]	you4 ji1 la1 si1	Larvitar Formerly 由基拉 Yóujīlā (TW/CN) 由基拉 Yàuhgēilāai (HK) Transliteration of its Japanese name. May also be from 安基拉斯 Ānjīlāsī
雨翅蛾[雨翅蛾]	yu3 chi4 e2	Masquerain From 雨 yǔ, 翅 chì, and 蛾 é
原盖海龟[原蓋海龜]	yuan2 gai4 hai3gui1	Tirtouga From 原蓋龜 Yuángàiguī and 海龜 hǎiguī
圆法师[圓法師]	yuan2 fa3shi1	Kricketot Literally "Round master". 法師 may be derived from つくつく法師 tsukutsuku-bōshi.
圆蝌蚪[圓蝌蚪]	yuan2 ke1dou3	Tympole Literally "Round tadpole".
圆陆鲨[圓陸鯊]	yuan2 lu4 sha1	Gible Literally "Round land shark"
圆丝蛛[圓絲蛛]	yuan2 si1 zhu1	Spinarak Formerly 線球 / 线球 Xiànqiú (TW/CN)  線球 Sinkàuh (HK) Literally means "Thread ball"
远古巨蜓[遠古巨蜓]	yuan3gu3 ju4 ting2	Yanmega Formerly 梅卡陽瑪 / 梅卡阳玛 Méikǎyángmǎ (TW/CN) 梅卡陽瑪 Mùihkāyèuhngmáh (HK) Transliteration of its Japanese name
怨影娃娃[怨影娃娃]	yuan4 ying3 wa2wa5	Shuppet From 怨 yuàn, 影 yǐng, and 娃娃 wáwá or 晴天娃娃 qíng​tiān-wá​wa
月桂叶[月桂葉]	yue4gui4ye4	Bayleef The Chinese name for bay leaf
月亮伊布[月亮伊布]	yue4liang5 yi1 bu4	Umbreon Formerly 月精靈 / 月精灵 Yuèjīnglíng (TW/CN) 月伊貝 Yuhtyībui (HK) Means "Moon spirit". Ends with -精靈 / -精灵 like every Eeveelution in Mandarin
月石[月石]	yue4shi2	Lunatone Literally "Moon stone"
战槌龙[戰槌龍]	zhan4 chui2 long2	Rampardos From 戰槌 zhànchuí and 龍 lóng
战舞郎[戰舞郎]	zhan4 wu3 lang2	Hitmontop Formerly 柯波朗 Kēbōlǎng (TW/CN) 柯波朗 Ōbōlòhng (HK) Partial transliteration of its Japanese name. 朗 may be from 郎 Láng, a character referring to young males
章鱼桶[章魚桶]	zhang1yu2 tong3	Octillery From 章魚 zhānyú and 桶 tǒng
长翅鸥[長翅鷗]	zhang3 chi4 ou1	Wingull Literally "Long-winged gull"
长耳兔[長耳兔]	zhang3 er3 tu4	Lopunny Literally "Long-eared rabbit".
长毛猪[長毛豬]	zhang3 mao2zhu1	Piloswine From 長毛 hángmáo, 長毛象 cháng​máo​xiàng, and 豬 zhū​
杖尾鳞甲龙[杖尾鱗甲龍]	zhang4 wei3 lin2jia3 long2	Kommo-o From 杖 zhàng, 尾巴 wěibā, 鱗甲 / 鳞甲 línjiǎ, and 龍 / 龙 lóng
沼王[沼王]	zhao3 wang2	Quagsire From 沼 zhǎo and 王 wáng
沼跃鱼[沼躍魚]	zhao3 yue4 yu2	Marshtomp Literally "Marsh jumping fish"
哲尔尼亚斯[哲爾尼亞斯]	zhe2 er3 ni2 ya4 si1	Xerneas Transliteration of Japanese name
榛果球[榛果球]	zhen1guo3 qiu2	Pineco Literally "Hazelnut ball"
珍珠贝[珍珠貝]	zhen1zhu1bei4	Clamperl Literally "Pearl shellfish"
正电拍拍[正電拍拍]	zheng4dian4 pai1 pai5	Plusle Literally "Positive charge clapping"
直冲熊[直衝熊]	zhi2 chong1 xiong2	Linoone Literally "Straight dashing bear". Contains 直 zhí, which both references the lines in its fur and its ability to run in straight lines
纸御剑[紙御劍]	zhi3 yu4 jian4	Kartana From 紙 / 纸 zhǐ and 御劍 / 御剑 yùjiàn
智挥猩[智揮猩]	zhi4 hui1 xing1	Oranguru From 智慧 zhìhuì, 指揮 / 指挥 zhǐhuī, 智多星 zhìduōxīng, and 猩猩 xīngxīng
种子铁球[種子鐵球]	zhong3zi5 tie3qiu2	Ferroseed From 種子 zhǒngzǐ and 鐵球 tiěqiú
重泥挽马[重泥挽馬]	zhong4 ni2 wan3ma3	Mudsdale From 重 zhòng, 泥 ní, and 挽馬 / 挽马 wǎnmǎ
烛光灵[燭光靈]	zhu2guang1 ling2	Litwick From 燭光 zhúguāng, 靈 líng, and 幽靈 yōulíng
自爆磁怪[自爆磁怪]	zi4bao4 ci2 guai4	Magnezone Literally "Self-detonating magnetic monster"
鬃岩狼人[鬃岩狼人]	zong1 yan2 lang2ren2	Lycanroc From 鬃狼 zōngláng, 岩 yán, 狼人 lángrén
走路草[走路草]	zou3lu4 cao3	Oddish Formerly 行路草 Hàahnglouhchóu (HK)  Literally "Traveling grass"
诅咒娃娃[詛咒娃娃]	zu3zhou4 wa2wa5	Banette Literally "Cursing doll"
钻角犀兽[鑽角犀獸]	zuan1 jiao3 xi1 shou4	Rhydon Formerly 鐵甲暴龍 / 铁甲暴龙 Tiějiǎbàolóng (TW/CN) 鐵甲暴龍 Titgaapbouhlùhng (HK) Means "Armored Tyrannosaurus"
坐骑山羊[坐騎山羊]	zuo4 ji4 shan1yang2	Gogoat Formerly 指路羊 Jílouh'yèuhng (HK)  Means "Mounting goat"
坐骑小羊[坐騎小羊]	zuo4 ji4 xiao3yang2	Skiddo Formerly 咩咩羊 Miēmiēyáng (TW) 咩咩羊 Mēmēyèuhng (HK) From 咩 miē and 羊 yáng
