炎兔儿		Scorbunny From 炎 yán and 兔兒 tù'ér
腾蹴小将		Raboot From 騰 / 腾 téng, 蹴 cù, and 小將 / 小将 xiǎojiàng
泪眼蜥		Sobble From 淚眼 / 泪眼 lèiyǎn and 蜥蜴 xīyì
变涩蜥		Drizzile From 變色龍 / 变色龙 biànsèlóng, 澀 / 涩 sè, and 蜥蜴 xīyì
闪焰王牌		Cinderace From 閃焰 / 闪焰 shǎnyàn and 王牌 wángpái
千面避役		Inteleon From 千面 qiānmiàn and 避役 bìyì
敲音猴		Grookey From 敲 qiāo, 音 yīn, and 猴 hóu
轰擂金刚猩		Rillaboom From 轟雷 / 轰雷 hōngléi, 擂 léi, 金剛 / 金刚 Jīn Gāng, and 大猩猩 dàxīngxīng
啪咚猴		Thwackey From 啪 pā, 咚 dōng, and 猴 hóu
贪心栗鼠		Skwovet From 貪心 / 贪心 tānxīn and 栗鼠 lìshǔ
稚山雀		Rookidee From 稚 zhì and 山雀 shānquè
藏饱栗鼠		Greedent From 藏 cáng, 飽 / 饱 bǎo and 栗鼠 lìshǔ
蓝鸦		Corvisquire From 藍 / 蓝 lán and 鴉 / 鸦 yā
钢铠鸦		Corviknight From 鋼 / 钢 gāng, 鎧 / 铠 kǎi, and 鴉 / 鸦 yā
索侦虫		Blipbug From 索 suǒ, 偵 / 侦 zhēn, and 蟲 / 虫 chóng
天罩虫		Dottler From 天線罩 / 天线罩 tiānxiànzhào and 天道虫 tentōmushi
以欧路普		Orbeetle Transcription of its Japanese name
狐大盗		Thievul From 狐 hú, 大 dà, and 大盜 dàdào
偷儿狐		Nickit From 偷 tōu, 兒 / 儿 ér, and 狐 hú
幼棉棉		Gossifleur From 幼 yòu, 棉 mián, and 幼綿綿 iùmîmî
白蓬蓬		Eldegoss From 白蓬蓬 báipéngpéng
毛辫羊		Wooloo From 羊毛 yángmáo, 辮 / 辫 biàn, and 羊 yáng
毛毛角羊		Dubwool From 羊毛 yángmáo, 角 jiǎo, and 羊 yáng
咬咬龟		Chewtle From 咬 yǎo and 龜 / 龟 guī
暴噬龟		Drednaw From 暴 bào, 噬 shì, and 龜 / 龟 guī
来电汪		Yamper From 來 / 来 lái, 電 / 电 diàn, and 汪汪 wāngwāng
逐电犬		Boltund From 追風逐電 / 追风逐电 zhuīfēng-zhúdiàn and 犬 quǎn
大炭车		Carkol From 大 dà, 炭 tàn and 礦車 / 矿车 kuàngchē
巨炭山		Coalossal From 巨 jù, 炭 tàn, and 山 shān
小炭仔		Rolycoly From 小 xiǎo, 炭 tàn, and 仔 zǐ
啃果虫		Applin From 啃 kěn, 果 guǒ, and 蟲 / 虫 chóng
苹裹龙		Flapple From 蘋果 / 苹果 píngguǒ, 裹 guǒ, and 龍 / 龙 lóng
丰蜜龙		Appletun From 豐 fēng, 蜜 mì, 蜂蜜 fēngmì, and 龍 lóng
沙包蛇		Silicobra From 沙 shā, 包 bāo , 沙包 shābāo, and 蛇 shé
沙螺蟒		Sandaconda From 沙 shā, 螺 luó, and 蟒 mǎng
古月鸟		Cramorant From 鶘 / 鹕 hú, may also incorporate 咕 gū and 噦 / 哕 yuě
刺梭鱼		Arrokuda From 刺 cì and 梭魚 / 梭鱼 suōyú
毒电婴		Toxel From 毒 dú, 電 / 电 diàn, and 嬰 / 婴 yīng
戽斗尖梭		Barraskewda From 戽斗 hùdǒu, 尖 jiān, and 梭魚 / 梭鱼 suōyú
/		Toxtricity From 顫 / 颤 zhàn / chàn, 弦 xián, and 蠑螈 / 蝾螈 róngyuán
烧火蚣		Sizzlipede From 燒火 / 烧火 shāohuǒ and 蜈蚣 wúgōng
焚焰蚣		Centiskorch From 焚 fén, 焰 yàn, and 蜈蚣 wúgōng
拳拳蛸		Clobbopus From 拳 quán and 蛸 xiāo
八爪武师		Grapploct From 八爪魚 / 八爪鱼 bāzhuǎyú and 武師 / 武师 wǔshī
来悲茶		Sinistea From 來 / 来 lái, 悲 bēi, 茶 chá, and a pun of 來杯茶 / 来杯茶 lái bēi chá
迷布莉姆		Hatenna Transcription of its Japanese name. Contains 迷 mí
怖思壶		Polteageist From 怖 bù, 思 sī, 壺 hú, 不死 bùsǐ, and 不是壺 bùshì hú
提布莉姆		Hattrem Transcription of its Japanese name
布莉姆温		Hatterene Transcription of its Japanese name
捣蛋小妖		Impidimp From 搗蛋 / 捣蛋 dǎodàn, 小 xiǎo, and 妖 yāo
诈唬魔		Morgrem From 詐唬 / 诈唬 zhàhǔ and 魔 mó
长毛巨魔		Grimmsnarl From 長毛 / 长毛 chángmáo, 巨 jù, and 魔 mó
堵拦熊		Obstagoon From 堵 dǔ, 攔 / 拦 lán, and 浣熊 wǎnxióng / huànxióng
喵头目		Perrserker From 喵 miāo and 頭目 / 头目 tóumù
死神板		Runerigus From 死神 sǐshén and 板 bǎn
魔灵珊瑚		Cursola From 魔 mó, 靈 / 灵 líng, and 珊瑚 shānhú
小仙奶		Milcery From 小仙子 xiǎoxiānzi and 奶 nǎi
霜奶仙		Alcremie From 糖霜 tángshuāng, 鮮奶油 xiānnǎiyóu, and 仙女 xiānnǚ
列阵兵		Falinks From 列陣 / 列阵 lièzhèn and 兵 bīng
葱游兵		Sirfetch'd From 蔥 / 葱 cōng, 遊 / 游 yóu, 兵 bīng, and 蔥油餅 / 葱油饼 cōngyóubǐng
啪嚓海胆		Pincurchin From 啪嚓啪嚓 pācāpācā and 海膽 / 海胆 hǎidǎn
雪吞虫		Snom From 雪 xuě, 吞 tūn, and 蟲 / 虫 chóng
踏冰人偶		Mr. Rime From 踢踏舞 tītàwǔ, 冰 bīng, and 人偶 rén'ǒu
雪绒蛾		Frosmoth From 雪 xuě, 絨 róng, 蛾 é, and 絨蛾 róng'é
巨石丁		Stonjourner From 巨石 jùshí and 丁 dīng
冰砌鹅		Eiscue From 冰 bīng, 砌 qì, and 企鵝 / 企鹅 qì'é / qǐ'é
爱管侍		Indeedee From 愛 ài, 管 guǎn, 侍者 shìzhě, and a pun of 愛管事 ài guǎn shì
铜象		Cufant From 銅 / 铜 tóng, 象 xiàng, and 銅像 / 铜像 tóngxiàng
莫鲁贝可		Morpeko Transcription of its Japanese name
大王铜象		Copperajah From 大王 dàwáng, 銅 / 铜 tóng, 象 xiàng, and 銅像 / 铜像 tóngxiàng
鳃鱼海兽		Arctovish From 鰓 / 鳃 sāi, 魚 / 鱼 yú, and 海獸 / 海兽 hǎishòu
铝钢龙		Duraludon From 鋁 / 铝 lǚ, 鋼 / 钢 gāng, and 龍 / 龙 lóng
雷鸟海兽		Arctozolt From 雷 léi, 鳥 / 鸟 niǎo, and 海獸 / 海兽 hǎishòu
雷鸟龙		Dracozolt From 雷 léi, 鳥 / 鸟 niǎo, and 龍 / 龙 lóng
鳃鱼龙		Dracovish From 鰓 / 鳃 sāi, 魚 / 鱼 yú, and 龍 / 龙 lóng
多龙梅西亚		Dreepy From the transcription of its Japanese name and 龍 / 龙 lóng
多龙奇		Drakloak Transcription of its Japanese name. Contains 龍 / 龙 lóng and 奇 qí
苍响		Zacian Transliteration of Japanese name. Also from 蒼藍 cānglán
多龙巴鲁托		Dragapult From the transcription of its Japanese name and 龍 / 龙 lóng
藏玛然特		Zamazenta Transliteration of Japanese name. Possibly from 藏紅色 Zànghóngsè
无极汰那		Eternatus From 無極 / 无极 wújí, 極巨化 / 极巨化 Jíjùhuà, and partial transcription of Japanese name
